ASIN	Title
B00NOL70Z0	ASICS Men's Athlete 2-in-1 Short 9-Inch, X-Large, Air Force Blue	
B00NVRL76A	ASICS Men's Club Short Sleeve T-Shirt, Real White, XX-Large	
B00NVRL3BE	ASICS Men's Club Short Sleeve T-Shirt, Real White, Large	
B00NVRL3AU	ASICS Men's Club Short Sleeve T-Shirt, Real White, Medium	
B00NVRL34Q	ASICS Men's Club Short Sleeve T-Shirt, Real White, Small	
B00NVRL6YS	ASICS Men's Club Short Sleeve T-Shirt, Real White, X-Large	
B00NVRL9VS	ASICS Men's Club Short Sleeve T-Shirt, Safety Yellow, XX-Large	
B00NVRL79W	ASICS Men's Club Short Sleeve T-Shirt, Safety Yellow, Large	
B00NVRL742	ASICS Men's Club Short Sleeve T-Shirt, Safety Yellow, Medium	
B00NVRL6ZC	ASICS Men's Club Short Sleeve T-Shirt, Safety Yellow, Small	
B00NVRLA08	ASICS Men's Club Short Sleeve T-Shirt, Safety Yellow, X-Large	
B00NVRLERC	ASICS Men's Club Short Sleeve T-Shirt, Shocking Orange, XX-Large	
B00NVRLA30	ASICS Men's Club Short Sleeve T-Shirt, Shocking Orange, Large	
B00NVRLA2Q	ASICS Men's Club Short Sleeve T-Shirt, Shocking Orange, Medium	
B00NVRL9XG	ASICS Men's Club Short Sleeve T-Shirt, Shocking Orange, Small	
B00NVRLG66	ASICS Men's Club Short Sleeve T-Shirt, Shocking Orange, X-Large	
B00YPRKX0G	Men's ASICS Club Short Sleeve Tee, True Red, XXL	
B00YPRKMUW	Men's ASICS Club Short Sleeve Tee, True Red, L	
B00YPRKPKE	Men's ASICS Club Short Sleeve Tee, True Red, M	
B00YPRKS4W	Men's ASICS Club Short Sleeve Tee, True Red, S	
B00YPRKUOU	Men's ASICS Club Short Sleeve Tee, True Red, XL	
B00YPRKK40	Men's ASICS Club Short Sleeve Tee, Blue Moon, XXL	
B00YPRK9GO	Men's ASICS Club Short Sleeve Tee, Blue Moon, L	
B00YPRKC1G	Men's ASICS Club Short Sleeve Tee, Blue Moon, M	
B00YPRKENM	Men's ASICS Club Short Sleeve Tee, Blue Moon, S	
B00YPRKHAW	Men's ASICS Club Short Sleeve Tee, Blue Moon, XL	
B00NVRLJ4A	ASICS Men's Club Short Sleeve T-Shirt, Oak Green, XX-Large	
B00NVRLEY0	ASICS Men's Club Short Sleeve T-Shirt, Oak Green, Large	
B00NVRLETA	ASICS Men's Club Short Sleeve T-Shirt, Oak Green, Medium	
B00NVRLF0I	ASICS Men's Club Short Sleeve T-Shirt, Oak Green, Small	
B00NVRLIVY	ASICS Men's Club Short Sleeve T-Shirt, Oak Green, X-Large	
B00NVRLMXS	ASICS Men's Club Short Sleeve T-Shirt, Air Force Blue, XX-Large	
B00NVRLJ6S	ASICS Men's Club Short Sleeve T-Shirt, Air Force Blue, Large	
B00NVRLJ18	ASICS Men's Club Short Sleeve T-Shirt, Air Force Blue, Medium	
B00NVRLIYQ	ASICS Men's Club Short Sleeve T-Shirt, Air Force Blue, Small	
B00NVRLMUG	ASICS Men's Club Short Sleeve T-Shirt, Air Force Blue, X-Large	
B00NVRLSFK	ASICS Men's Club Graphic Short Sleeve T-Shirt, Graphic Stripe Oak Green, XX-Large	
B00NVRLN3W	ASICS Men's Club Graphic Short Sleeve T-Shirt, Graphic Stripe Oak Green, Large	
B00NVRLMRY	ASICS Men's Club Graphic Short Sleeve T-Shirt, Graphic Stripe Oak Green, Medium	
B00NVRLMZQ	ASICS Men's Club Graphic Short Sleeve T-Shirt, Graphic Stripe Oak Green, Small	
B00NVRLX1O	ASICS Men's Club Graphic Short Sleeve T-Shirt, Graphic Stripe Safety Yellow, XX-Large	
B00NVRLS78	ASICS Men's Club Graphic Short Sleeve T-Shirt, Graphic Stripe Safety Yellow, Large	
B00NVRLS46	ASICS Men's Club Graphic Short Sleeve T-Shirt, Graphic Stripe Safety Yellow, Medium	
B00NVRLSBE	ASICS Men's Club Graphic Short Sleeve T-Shirt, Graphic Stripe Safety Yellow, Small	
B00NVRLX32	ASICS Men's Club Graphic Short Sleeve T-Shirt, Graphic Stripe Safety Yellow, X-Large	
B00NVRMRX2	ASICS Men's Club Graphic Short Sleeve T-Shirt, Graphic Stripe Real White, XX-Large	
B00NVRMUAC	ASICS Men's Club Graphic Short Sleeve T-Shirt, Graphic Stripe Air Force Blue, XX-Large	
B00NVRMUI4	ASICS Men's Club Graphic Short Sleeve T-Shirt, Graphic Stripe Air Force Blue, Large	
B00NVRMUBQ	ASICS Men's Club Graphic Short Sleeve T-Shirt, Graphic Stripe Air Force Blue, Small	
B00YPRJ7VM	Men's ASICS Club Graphic Short Sleeve Tee, Real White Stripe, XXL	
B00YPRHYK8	Men's ASICS Club Graphic Short Sleeve Tee, Real White Stripe, L	
B00YPRI13W	Men's ASICS Club Graphic Short Sleeve Tee, Real White Stripe, M	
B00YPRI3I0	Men's ASICS Club Graphic Short Sleeve Tee, Real White Stripe, S	
B00YPRJ4VU	Men's ASICS Club Graphic Short Sleeve Tee, Real White Stripe, XL	
B00YPRK1KI	Men's ASICS Club Graphic Short Sleeve Tee, True Red Stripe , XXL	
B00YPRJPK0	Men's ASICS Club Graphic Short Sleeve Tee, True Red Stripe , L	
B00YPRJS70	Men's ASICS Club Graphic Short Sleeve Tee, True Red Stripe , M	
B00YPRJUV4	Men's ASICS Club Graphic Short Sleeve Tee, True Red Stripe , S	
B00YPRJXES	Men's ASICS Club Graphic Short Sleeve Tee, True Red Stripe , XL	
B00YPRJMPI	Men's ASICS Club Graphic Short Sleeve Tee, Mosaic Blue Stripe , XXL	
B00YPRJAR8	Men's ASICS Club Graphic Short Sleeve Tee, Mosaic Blue Stripe , L	
B00YPRJDNY	Men's ASICS Club Graphic Short Sleeve Tee, Mosaic Blue Stripe , M	
B00YPRJGNQ	Men's ASICS Club Graphic Short Sleeve Tee, Mosaic Blue Stripe , S	
B00YPRJJDS	Men's ASICS Club Graphic Short Sleeve Tee, Mosaic Blue Stripe , XL	
B00YPS3EZ6	Mens ASICS Club V-Neck Tee, Real White, XXL	
B00YPS35CI	Mens ASICS Club V-Neck Tee, Real White, L	
B00YPS383E	Mens ASICS Club V-Neck Tee, Real White, M	
B00YPS3ATG	Mens ASICS Club V-Neck Tee, Real White, S	
B00YPS3CEY	Mens ASICS Club V-Neck Tee, Real White, XL	
B00YPS32M6	Mens ASICS Club V-Neck Tee, Performance Black, XXL	
B00YPS2S0I	Mens ASICS Club V-Neck Tee, Performance Black, L	
B00YPS2V7S	Mens ASICS Club V-Neck Tee, Performance Black, M	
B00YPS2XBM	Mens ASICS Club V-Neck Tee, Performance Black, S	
B00YPS301O	Mens ASICS Club V-Neck Tee, Performance Black, XL	
B00YPS3S9S	Mens ASICS Club V-Neck Tee, Mosaic Blue, XXL	
B00YPS3H8K	Mens ASICS Club V-Neck Tee, Mosaic Blue, L	
B00YPS3KG4	Mens ASICS Club V-Neck Tee, Mosaic Blue, M	
B00YPS3NA2	Mens ASICS Club V-Neck Tee, Mosaic Blue, S	
B00YPS3PSW	Mens ASICS Club V-Neck Tee, Mosaic Blue, XL	
B00NVRMX4U	ASICS Men's Club Short Sleeve Polo, Real White, Large	
B00NVRMWZA	ASICS Men's Club Short Sleeve Polo, Real White, Medium	
B00NVRMWZU	ASICS Men's Club Short Sleeve Polo, Real White, Small	
B00NVRMX2C	ASICS Men's Club Short Sleeve Polo, Real White, X-Large	
B00YPRLEZE	Men's ASICS Club Short Sleeve Polo, Blue Moon, XXL	
B00YPRL314	Men's ASICS Club Short Sleeve Polo, Blue Moon, L	
B00YPRL5VM	Men's ASICS Club Short Sleeve Polo, Blue Moon, M	
B00YPRL91I	Men's ASICS Club Short Sleeve Polo, Blue Moon, S	
B00YPRLBUW	Men's ASICS Club Short Sleeve Polo, Blue Moon, XL	
B00NVRN0AQ	ASICS Men's Club Short Sleeve Polo, Performance Black, XX-Large	
B00NVRN2KE	ASICS Men's Club Short Sleeve Polo, Performance Black, Large	
B00NVRN0GK	ASICS Men's Club Short Sleeve Polo, Performance Black, Medium	
B00NVRN0IS	ASICS Men's Club Short Sleeve Polo, Performance Black, Small	
B00NVRN0DI	ASICS Men's Club Short Sleeve Polo, Performance Black, X-Large	
B00NVRN6ZK	ASICS Men's Club Short Sleeve Polo, Oak Green, Large	
B00NVRN6OQ	ASICS Men's Club Short Sleeve Polo, Oak Green, Medium	
B00NVRN7CW	ASICS Men's Club Short Sleeve Polo, Oak Green, Small	
B00NVRN6QO	ASICS Men's Club Short Sleeve Polo, Oak Green, X-Large	
B00NVRNBG4	ASICS Men's Club Short Sleeve Polo, Air Force Blue, Large	
B00NVRNBB4	ASICS Men's Club Short Sleeve Polo, Air Force Blue, Medium	
B00NVRNB5U	ASICS Men's Club Short Sleeve Polo, Air Force Blue, Small	
B00NVRNBDM	ASICS Men's Club Short Sleeve Polo, Air Force Blue, X-Large	
B00NVRNGYQ	ASICS Women's Athlete Tank Top, Sunshine Yellow, Large	
B00NVRNGVO	ASICS Women's Athlete Tank Top, Sunshine Yellow, Medium	
B00NVRNGV4	ASICS Women's Athlete Tank Top, Sunshine Yellow, Small	
B00NVRNH7W	ASICS Women's Athlete Tank Top, Sunshine Yellow, X-Large	
B00NVRNGPA	ASICS Women's Athlete Tank Top, Sunshine Yellow, X-Small	
B00NOL755K	ASICS Women's Athlete Tank Top, Large, Fizzy Peach	
B00NOL78IY	ASICS Women's Athlete Tank Top, Medium, Fizzy Peach	
B00NOL76HW	ASICS Women's Athlete Tank Top, Small, Fizzy Peach	
B00NVRNJWU	ASICS Women's Athlete Tank Top, Performance Black, Medium	
B00NVRNK4C	ASICS Women's Athlete Tank Top, Performance Black, Small	
B00NVRNMTA	ASICS Women's Athlete Tank Top, Performance Black, X-Small	
B00NVRNRAO	ASICS Women's Athlete Tank Top, Cool Mint, Large	
B00NVRNRD6	ASICS Women's Athlete Tank Top, Cool Mint, Medium	
B00NVRNR4K	ASICS Women's Athlete Tank Top, Cool Mint, Small	
B00NVRNRBI	ASICS Women's Athlete Tank Top, Cool Mint, X-Large	
B00NVRNRFO	ASICS Women's Athlete Tank Top, Cool Mint, X-Small	
B00NVRNUX8	ASICS Women's Athlete Short Sleeve T-Shirt, Sunshine Yellow, Medium	
B00NVRQ5QM	ASICS Women's Athlete Short Sleeve T-Shirt, Coralicious, Large	
B00NVRQ5U8	ASICS Women's Athlete Short Sleeve T-Shirt, Coralicious, Medium	
B00NVRQ5OE	ASICS Women's Athlete Short Sleeve T-Shirt, Coralicious, Small	
B00NVRQ5PI	ASICS Women's Athlete Short Sleeve T-Shirt, Coralicious, X-Large	
B00NVRQ0A8	ASICS Women's Athlete Short Sleeve T-Shirt, Coralicious, X-Small	
B00NVRQB9I	ASICS Women's Athlete Short Sleeve T-Shirt, Performance Black, Large	
B00NVRQBBG	ASICS Women's Athlete Short Sleeve T-Shirt, Performance Black, Medium	
B00NVRQB1Q	ASICS Women's Athlete Short Sleeve T-Shirt, Performance Black, Small	
B00NVRQ5QW	ASICS Women's Athlete Short Sleeve T-Shirt, Performance Black, X-Small	
B00NVRQE22	ASICS Women's Athlete Short Sleeve T-Shirt, Cool Mint, Large	
B00NVRQDSC	ASICS Women's Athlete Short Sleeve T-Shirt, Cool Mint, Medium	
B00NVRQE0O	ASICS Women's Athlete Short Sleeve T-Shirt, Cool Mint, Small	
B00NVRQE1S	ASICS Women's Athlete Short Sleeve T-Shirt, Cool Mint, X-Large	
B00NVRQB84	ASICS Women's Athlete Short Sleeve T-Shirt, Cool Mint, X-Small	
B00NOL7B3Q	ASICS Women's Athlete Long Sleeve Top, Large, Real White	
B00NOL7B4U	ASICS Women's Athlete Long Sleeve Top, Medium, Real White	
B00NOL7BB8	ASICS Women's Athlete Long Sleeve Top, Small, Real White	
B00NOL7B7W	ASICS Women's Athlete Long Sleeve Top, X-Small, Real White	
B00NVRQJZ4	ASICS Women's Athlete Long Sleeve Top, Coralicious, Large	
B00NVRQK76	ASICS Women's Athlete Long Sleeve Top, Coralicious, Medium	
B00NVRQKCG	ASICS Women's Athlete Long Sleeve Top, Coralicious, Small	
B00NVRQK1W	ASICS Women's Athlete Long Sleeve Top, Coralicious, X-Large	
B00NVRQDWS	ASICS Women's Athlete Long Sleeve Top, Coralicious, X-Small	
B00NVRQMZ6	ASICS Women's Athlete Long Sleeve Top, Cool Mint, Large	
B00NVRQMZQ	ASICS Women's Athlete Long Sleeve Top, Cool Mint, Medium	
B00NVRQNM8	ASICS Women's Athlete Long Sleeve Top, Cool Mint, Small	
B00NVRQN4G	ASICS Women's Athlete Long Sleeve Top, Cool Mint, X-Large	
B00NVRQJYU	ASICS Women's Athlete Long Sleeve Top, Cool Mint, X-Small	
B00NVRQSBE	ASICS Women's Athlete Skort, Real White, Medium	
B00NVRQSA0	ASICS Women's Athlete Skort, Real White, X-Large	
B00NOL7G68	ASICS Women's Athlete Skort, Large, Coralicious	
B00NOL7H9O	ASICS Women's Athlete Skort, Medium, Coralicious	
B00NOL7G9U	ASICS Women's Athlete Skort, Small, Coralicious	
B00NOL7GC2	ASICS Women's Athlete Skort, X-Small, Coralicious	
B00NVRQX7S	ASICS Women's Athlete Skort, Performance Black, Large	
B00NVRQWM4	ASICS Women's Athlete Skort, Performance Black, Medium	
B00NVRQXAA	ASICS Women's Athlete Skort, Performance Black, Small	
B00NVRQSAK	ASICS Women's Athlete Skort, Performance Black, X-Small	
B00NVRRGI8	ASICS Women's Athlete Skort, Cool Mint, Medium	
B00NVRRB5G	ASICS Women's Athlete Skort, Cool Mint, X-Small	
B00NOL7M44	ASICS Women's Athlete Dress, Large, Coralicious	
B00NOL7M7G	ASICS Women's Athlete Dress, Medium, Coralicious	
B00NOL7LY0	ASICS Women's Athlete Dress, Small, Coralicious	
B00NOL7M4E	ASICS Women's Athlete Dress, X-Small, Coralicious	
B00NVQK2BC	ASICS Women's Athlete Dress, Cool Mint, Large	
B00NVQK262	ASICS Women's Athlete Dress, Cool Mint, Medium	
B00NVQK23K	ASICS Women's Athlete Dress, Cool Mint, Small	
B00NVQK8UM	ASICS Women's Athlete Dress, Cool Mint, X-Large	
B00NVQK24E	ASICS Women's Athlete Dress, Cool Mint, X-Small	
B00NVQK8UC	ASICS Women's Club Tank Top, Real White, Medium	
B00NVQK8U2	ASICS Women's Club Tank Top, Real White, Small	
B00NVQK8TI	ASICS Women's Club Tank Top, Real White, X-Small	
B00NVQKCBW	ASICS Women's Club Tank Top, Coralicious, Large	
B00NVQKC80	ASICS Women's Club Tank Top, Coralicious, Medium	
B00NVQKFYG	ASICS Women's Club Tank Top, Coralicious, X-Large	
B00NVQKD6Q	ASICS Women's Club Tank Top, Coralicious, X-Small	
B00NVQKG6S	ASICS Women's Club Tank Top, Performance Black, Large	
B00NVQKGAY	ASICS Women's Club Tank Top, Performance Black, Medium	
B00NVQKG3G	ASICS Women's Club Tank Top, Performance Black, Small	
B00NVQKG68	ASICS Women's Club Tank Top, Performance Black, X-Small	
B00NVQKJOM	ASICS Women's Club Tank Top, Cool Mint, Large	
B00NVQKJL0	ASICS Women's Club Tank Top, Cool Mint, Medium	
B00NVQKJWE	ASICS Women's Club Tank Top, Cool Mint, Small	
B00NVQKRKI	ASICS Women's Club Tank Top, Cool Mint, X-Large	
B00NVQKJM4	ASICS Women's Club Tank Top, Cool Mint, X-Small	
B00NVQKMMQ	ASICS Women's Club V-Neck Top, Real White, Large	
B00NVQKMMG	ASICS Women's Club V-Neck Top, Real White, Medium	
B00NVQKMJO	ASICS Women's Club V-Neck Top, Real White, Small	
B00NVQKUY6	ASICS Women's Club V-Neck Top, Real White, X-Large	
B00NVQKMOO	ASICS Women's Club V-Neck Top, Real White, X-Small	
B00NVQKV5O	ASICS Women's Club V-Neck Top, Coralicious, Large	
B00NVQKUOQ	ASICS Women's Club V-Neck Top, Coralicious, Medium	
B00NVQKUW8	ASICS Women's Club V-Neck Top, Coralicious, Small	
B00NVQKYB0	ASICS Women's Club V-Neck Top, Coralicious, X-Large	
B00NVQKUUU	ASICS Women's Club V-Neck Top, Coralicious, X-Small	
B00UR3QJJ6	ASICS Women's Club Tennis V-Neck Top, Marina, Large	
B00UR3QO3M	ASICS Women's Club Tennis V-Neck Top, Marina, Medium	
B00UR3QO1E	ASICS Women's Club Tennis V-Neck Top, Marina, Small	
B00UR3QO8C	ASICS Women's Club Tennis V-Neck Top, Marina, X-Large	
B00UR3QNZG	ASICS Women's Club Tennis V-Neck Top, Marina, X-Small	
B00NVQKYOW	ASICS Women's Club V-Neck Top, Cool Mint, Large	
B00NVQKY9M	ASICS Women's Club V-Neck Top, Cool Mint, Medium	
B00NVQKYA6	ASICS Women's Club V-Neck Top, Cool Mint, Small	
B00NVQL4KA	ASICS Women's Club V-Neck Top, Cool Mint, X-Large	
B00NVQKYME	ASICS Women's Club V-Neck Top, Cool Mint, X-Small	
B00UR3QODW	ASICS Women's Club Tennis V-Neck Top, Dark Cobalt, Large	
B00UR3QO78	ASICS Women's Club Tennis V-Neck Top, Dark Cobalt, Medium	
B00UR3QO6E	ASICS Women's Club Tennis V-Neck Top, Dark Cobalt, Small	
B00UR3QQRQ	ASICS Women's Club Tennis V-Neck Top, Dark Cobalt, X-Large	
B00UR3QQWG	ASICS Women's Club Tennis V-Neck Top, Dark Cobalt, X-Small	
B00NVQOW0Y	ASICS Women's Club Racerback Sleeveless Polo, Real White, Large	
B00NVQOVVY	ASICS Women's Club Racerback Sleeveless Polo, Real White, Medium	
B00NVQOW5E	ASICS Women's Club Racerback Sleeveless Polo, Real White, Small	
B00NVQOVZ0	ASICS Women's Club Racerback Sleeveless Polo, Real White, X-Large	
B00NVQL4W8	ASICS Women's Club Racerback Sleeveless Polo, Real White, X-Small	
B00NVQOYRK	ASICS Women's Club Racerback Sleeveless Polo, Sunshine Yellow, Large	
B00NVQOYNE	ASICS Women's Club Racerback Sleeveless Polo, Sunshine Yellow, Medium	
B00NVQOYNY	ASICS Women's Club Racerback Sleeveless Polo, Sunshine Yellow, Small	
B00NVQOYO8	ASICS Women's Club Racerback Sleeveless Polo, Sunshine Yellow, X-Large	
B00NVQOYSO	ASICS Women's Club Racerback Sleeveless Polo, Sunshine Yellow, X-Small	
B00NVQP1AE	ASICS Women's Club Racerback Sleeveless Polo, Coralicious, Large	
B00NVQP19U	ASICS Women's Club Racerback Sleeveless Polo, Coralicious, Medium	
B00NVQP15Y	ASICS Women's Club Racerback Sleeveless Polo, Coralicious, Small	
B00NVQP1EA	ASICS Women's Club Racerback Sleeveless Polo, Coralicious, X-Large	
B00NVQP1BI	ASICS Women's Club Racerback Sleeveless Polo, Coralicious, X-Small	
B00NVQP3LG	ASICS Women's Club Short Sleeve Polo, Real White, Large	
B00NVQP3SY	ASICS Women's Club Short Sleeve Polo, Real White, Medium	
B00NVQP41K	ASICS Women's Club Short Sleeve Polo, Real White, Small	
B00NVQP3X4	ASICS Women's Club Short Sleeve Polo, Real White, X-Large	
B00NVQP3YS	ASICS Women's Club Short Sleeve Polo, Real White, X-Small	
B00YPRRJWG	Women's ASICS Club Short Sleeve Polo, Marina, L	
B00YPRRNZ4	Women's ASICS Club Short Sleeve Polo, Marina, M	
B00YPRRQM4	Women's ASICS Club Short Sleeve Polo, Marina, S	
B00YPRRUG6	Women's ASICS Club Short Sleeve Polo, Marina, XL	
B00YPRRXJK	Women's ASICS Club Short Sleeve Polo, Marina, XS	
B00NVQP6KY	ASICS Women's Club Short Sleeve Polo, Performance Black, Large	
B00NVQP6BS	ASICS Women's Club Short Sleeve Polo, Performance Black, Medium	
B00NVQP6CW	ASICS Women's Club Short Sleeve Polo, Performance Black, Small	
B00NVQP6DG	ASICS Women's Club Short Sleeve Polo, Performance Black, X-Large	
B00NVQP6H2	ASICS Women's Club Short Sleeve Polo, Performance Black, X-Small	
B00NVQP9ZQ	ASICS Women's Club Short Sleeve Polo, Cool Mint, Large	
B00NVQPA5A	ASICS Women's Club Short Sleeve Polo, Cool Mint, Medium	
B00NVQPA0U	ASICS Women's Club Short Sleeve Polo, Cool Mint, Small	
B00NVQPA4G	ASICS Women's Club Short Sleeve Polo, Cool Mint, X-Large	
B00NVQPA5K	ASICS Women's Club Short Sleeve Polo, Cool Mint, X-Small	
B00NVQPCYY	ASICS Women's Club Skort, Real White, Large	
B00NVQPD3E	ASICS Women's Club Skort, Real White, Medium	
B00NVQPCZS	ASICS Women's Club Skort, Real White, Small	
B00NVQPCY4	ASICS Women's Club Skort, Real White, X-Large	
B00NVQPRLM	ASICS Women's Club Skort, Real White, X-Small	
B00NVQPXXY	ASICS Women's Club Skort, Coralicious, Large	
B00NVQPX9I	ASICS Women's Club Skort, Coralicious, Medium	
B00NVQPXWA	ASICS Women's Club Skort, Coralicious, Small	
B00NVQPYDS	ASICS Women's Club Skort, Coralicious, X-Large	
B00NVQPXW0	ASICS Women's Club Skort, Coralicious, X-Small	
B00NVQQ2ZC	ASICS Women's Club Skort, Performance Black, Large	
B00NVQQ2J8	ASICS Women's Club Skort, Performance Black, Medium	
B00NVQQ2WK	ASICS Women's Club Skort, Performance Black, Small	
B00NVQQ34M	ASICS Women's Club Skort, Performance Black, X-Large	
B00NVQQ22K	ASICS Women's Club Skort, Performance Black, X-Small	
B00NVQQ7O8	ASICS Women's Club Skort, Cool Mint, Large	
B00NVQQ720	ASICS Women's Club Skort, Cool Mint, Medium	
B00NVQQ6KS	ASICS Women's Club Skort, Cool Mint, Small	
B00NVQQ6W6	ASICS Women's Club Skort, Cool Mint, X-Large	
B00NVQQ73E	ASICS Women's Club Skort, Cool Mint, X-Small	
B00UR3QJL4	ASICS Women's Club Tennis Skort, Dark Cobalt, Large	
B00UR3QJGE	ASICS Women's Club Tennis Skort, Dark Cobalt, Medium	
B00UR3QKK4	ASICS Women's Club Tennis Skort, Dark Cobalt, Small	
B00UR3QJH8	ASICS Women's Club Tennis Skort, Dark Cobalt, X-Large	
B00UR3QJN2	ASICS Women's Club Tennis Skort, Dark Cobalt, X-Small	
B00KNECTNY	ASICS Men's Train for Sport Sleeveless Top, Safety Yellow, XX-Large	
B00KNECUPQ	ASICS Men's Train for Sport Sleeveless Top, Safety Yellow, Large	
B00KNECW4U	ASICS Men's Train for Sport Sleeveless Top, Safety Yellow, Medium	
B00KNECXHQ	ASICS Men's Train for Sport Sleeveless Top, Safety Yellow, Small	
B00KNECYCU	ASICS Men's Train for Sport Sleeveless Top, Safety Yellow, X-Large	
B00KNECNO4	ASICS Men's Sleeveless Top, XX-Large, Performance Black	
B00KNECOQQ	ASICS Men's Sleeveless Top, Large, Performance Black	
B00KNECPUQ	ASICS Men's Sleeveless Top, Medium, Performance Black	
B00KNECQZK	ASICS Men's Sleeveless Top, Small, Performance Black	
B00KNECRU4	ASICS Men's Sleeveless Top, X-Large, Performance Black	
B00KNECZBU	ASICS Men's Train for Sport Sleeveless Top, Atomic Blue, XX-Large	
B00KNED0EQ	ASICS Men's Train for Sport Sleeveless Top, Atomic Blue, Large	
B00KNED1D6	ASICS Men's Train for Sport Sleeveless Top, Atomic Blue, Medium	
B00KNED29O	ASICS Men's Train for Sport Sleeveless Top, Atomic Blue, Small	
B00KNED3DE	ASICS Men's Train for Sport Sleeveless Top, Atomic Blue, X-Large	
B00KNED5SW	ASICS Men's Sleeveless Top, Large, Air Force Blue Heather	
B00KNED6RC	ASICS Men's Sleeveless Top, Medium, Air Force Blue Heather	
B00KNED7TO	ASICS Men's Sleeveless Top, Small, Air Force Blue Heather	
B00KNED9PG	ASICS Men's Sleeveless Top, X-Large, Air Force Blue Heather	
B00NVQVWAW	ASICS Men's Train for Sport Graphic T-Shirt, Safety Yellow, XX-Large	
B00NVQVX9W	ASICS Men's Train for Sport Graphic T-Shirt, Safety Yellow, Large	
B00NVQVT4G	ASICS Men's Train for Sport Graphic T-Shirt, Safety Yellow, Medium	
B00NVQVSN8	ASICS Men's Train for Sport Graphic T-Shirt, Safety Yellow, Small	
B00NVQVWFM	ASICS Men's Train for Sport Graphic T-Shirt, Safety Yellow, X-Large	
B00NOL7UTG	ASICS Men's Graphic Tee T-shirt, Large, Shocking Orange	
B00NOL7UNM	ASICS Men's Graphic Tee T-shirt, Medium, Shocking Orange	
B00NOL7UO6	ASICS Men's Graphic Tee T-shirt, Small, Shocking Orange	
B00NOL7UN2	ASICS Men's Graphic Tee T-shirt, X-Large, Shocking Orange	
B00NVQW12K	ASICS Men's Train for Sport Graphic T-Shirt, Dark Grey Heather, XX-Large	
B00NVQW0VM	ASICS Men's Train for Sport Graphic T-Shirt, Dark Grey Heather, Large	
B00NVQVWK2	ASICS Men's Train for Sport Graphic T-Shirt, Dark Grey Heather, Medium	
B00NVQVXB0	ASICS Men's Train for Sport Graphic T-Shirt, Dark Grey Heather, Small	
B00NVQW11Q	ASICS Men's Train for Sport Graphic T-Shirt, Dark Grey Heather, X-Large	
B00NVQW6AW	ASICS Men's Train for Sport Graphic T-Shirt, Atomic Blue, XX-Large	
B00NVQW6L6	ASICS Men's Train for Sport Graphic T-Shirt, Atomic Blue, Large	
B00NVQW1FW	ASICS Men's Train for Sport Graphic T-Shirt, Atomic Blue, Medium	
B00NVQW33W	ASICS Men's Train for Sport Graphic T-Shirt, Atomic Blue, Small	
B00NVQW832	ASICS Men's Train for Sport Graphic T-Shirt, Atomic Blue, X-Large	
B00NOL7YWO	ASICS Men's Graphic Tee T-shirt, XX-Large, Air Force Blue	
B00NOL7YTC	ASICS Men's Graphic Tee T-shirt, Large, Air Force Blue	
B00NOL7Z2I	ASICS Men's Graphic Tee T-shirt, Medium, Air Force Blue	
B00NOL7YOM	ASICS Men's Graphic Tee T-shirt, Small, Air Force Blue	
B00NOL7YQK	ASICS Men's Graphic Tee T-shirt, X-Large, Air Force Blue	
B00NVQWBKW	ASICS Men's Train for Sport Print T-Shirt, Oak Green Grid, XX-Large	
B00NVQWBHA	ASICS Men's Train for Sport Print T-Shirt, Oak Green Grid, Large	
B00NVQW6E8	ASICS Men's Train for Sport Print T-Shirt, Oak Green Grid, Medium	
B00NVQW706	ASICS Men's Train for Sport Print T-Shirt, Oak Green Grid, Small	
B00NVQWC4M	ASICS Men's Train for Sport Print T-Shirt, Oak Green Grid, X-Large	
B00NOL82LG	ASICS Men's Print Tee T-shirt, XX-Large, Air Force Blue/Shocking Orange	
B00NOL82IE	ASICS Men's Print Tee T-shirt, Large, Air Force Blue/Shocking Orange	
B00NOL82Q6	ASICS Men's Print Tee T-shirt, Medium, Air Force Blue/Shocking Orange	
B00NOL82PW	ASICS Men's Print Tee T-shirt, Small, Air Force Blue/Shocking Orange	
B00NOL82S4	ASICS Men's Print Tee T-shirt, X-Large, Air Force Blue/Shocking Orange	
B00NVR6VPC	ASICS Men's Train for Sport Print T-Shirt, Air Force Blue Grid, XX-Large	
B00NVR6T0E	ASICS Men's Train for Sport Print T-Shirt, Air Force Blue Grid, Large	
B00NVR6T2C	ASICS Men's Train for Sport Print T-Shirt, Air Force Blue Grid, Medium	
B00NVR6SXW	ASICS Men's Train for Sport Print T-Shirt, Air Force Blue Grid, Small	
B00NVR6VNY	ASICS Men's Train for Sport Print T-Shirt, Air Force Blue Grid, X-Large	
B00NOL86TO	ASICS Men's Print Tee T-shirt, XX-Large, Performance Black Grid	
B00NOL86K8	ASICS Men's Print Tee T-shirt, Large, Performance Black Grid	
B00NOL86MQ	ASICS Men's Print Tee T-shirt, Medium, Performance Black Grid	
B00NOL86Q2	ASICS Men's Print Tee T-shirt, Small, Performance Black Grid	
B00NOL86SU	ASICS Men's Print Tee T-shirt, X-Large, Performance Black Grid	
B00NVR70KM	ASICS Men's Train for Sport Graphic Long Sleeve T-Shirt, Performance Black, XX-Large	
B00NVR6XX2	ASICS Men's Train for Sport Graphic Long Sleeve T-Shirt, Performance Black, Large	
B00NVR6XTQ	ASICS Men's Train for Sport Graphic Long Sleeve T-Shirt, Performance Black, Medium	
B00NVR6VN4	ASICS Men's Train for Sport Graphic Long Sleeve T-Shirt, Performance Black, Small	
B00NVR70NY	ASICS Men's Train for Sport Graphic Long Sleeve T-Shirt, Performance Black, X-Large	
B00NVR74YY	ASICS Men's Train for Sport Graphic Long Sleeve T-Shirt, Oak Green Heather, XX-Large	
B00NVR70Q6	ASICS Men's Train for Sport Graphic Long Sleeve T-Shirt, Oak Green Heather, Large	
B00NVR70R0	ASICS Men's Train for Sport Graphic Long Sleeve T-Shirt, Oak Green Heather, Medium	
B00NVR724Q	ASICS Men's Train for Sport Graphic Long Sleeve T-Shirt, Oak Green Heather, Small	
B00NVR748U	ASICS Men's Train for Sport Graphic Long Sleeve T-Shirt, Oak Green Heather, X-Large	
B00NOL8AEK	ASICS Men's Graphic Long Sleeve Tee T-shirt, XX-Large, Air Force Blue Heather	
B00NOL8A40	ASICS Men's Graphic Long Sleeve Tee T-shirt, Large, Air Force Blue Heather	
B00NOL89XW	ASICS Men's Graphic Long Sleeve Tee T-shirt, Medium, Air Force Blue Heather	
B00NOL89XM	ASICS Men's Graphic Long Sleeve Tee T-shirt, Small, Air Force Blue Heather	
B00NOL89Z0	ASICS Men's Graphic Long Sleeve Tee T-shirt, X-Large, Air Force Blue Heather	
B00NOL8DYC	ASICS Men's Track Jacket, XX-Large, Shocking Orange	
B00NOL8DXS	ASICS Men's Track Jacket, Large, Shocking Orange	
B00NOL8DRO	ASICS Men's Track Jacket, Medium, Shocking Orange	
B00NOL8DSI	ASICS Men's Track Jacket, Small, Shocking Orange	
B00NOL8DYM	ASICS Men's Track Jacket, X-Large, Shocking Orange	
B00KNEHDUI	ASICS Men's Track Jacket, Large, Performance Black	
B00KNEHF3I	ASICS Men's Track Jacket, Medium, Performance Black	
B00KNEHI5S	ASICS Men's Track Jacket, Small, Performance Black	
B00KNEHLO6	ASICS Men's Track Jacket, X-Large, Performance Black	
B00KNEH54M	ASICS Men's Train for Sport Track Jacket, Oak Green, Large	
B00KNEH6XM	ASICS Men's Train for Sport Track Jacket, Oak Green, Medium	
B00KNEH8YY	ASICS Men's Train for Sport Track Jacket, Oak Green, Small	
B00KNEHAVU	ASICS Men's Train for Sport Track Jacket, Oak Green, X-Large	
B00NOL8JI2	ASICS Men's Track Jacket, Large, Air Force Blue	
B00NOL8JCS	ASICS Men's Track Jacket, Medium, Air Force Blue	
B00NOL8JAA	ASICS Men's Track Jacket, Small, Air Force Blue	
B00NOL8JNC	ASICS Men's Track Jacket, X-Large, Air Force Blue	
B00NOL8NJ2	ASICS Men's FZ Hoodie, Large, Dark Grey Heather	
B00NOL8NBA	ASICS Men's FZ Hoodie, Medium, Dark Grey Heather	
B00NOL8NNS	ASICS Men's FZ Hoodie, Small, Dark Grey Heather	
B00NOL8NLU	ASICS Men's FZ Hoodie, X-Large, Dark Grey Heather	
B00NOL8UAO	ASICS Men's FZ Hoodie, XX-Large, Atomic Blue	
B00NOL8UDG	ASICS Men's FZ Hoodie, Large, Atomic Blue	
B00NOL8UJU	ASICS Men's FZ Hoodie, Medium, Atomic Blue	
B00NOL8UNQ	ASICS Men's FZ Hoodie, Small, Atomic Blue	
B00NOL8UDQ	ASICS Men's FZ Hoodie, X-Large, Atomic Blue	
B00NOL8XV0	ASICS Men's FZ Hoodie, XX-Large, Air Force Blue	
B00NOL8XS8	ASICS Men's FZ Hoodie, Large, Air Force Blue	
B00NOL8XRY	ASICS Men's FZ Hoodie, Medium, Air Force Blue	
B00NOL8XMY	ASICS Men's FZ Hoodie, Small, Air Force Blue	
B00NOL8XKG	ASICS Men's FZ Hoodie, X-Large, Air Force Blue	
B00NOL940E	ASICS Men's Woven 9-Inch Short, Small, Performance Black	
B00NOL94MW	ASICS Men's Woven 9-Inch Short, X-Large, Performance Black	
B00NVRB850	ASICS Men's Train for Sport 9-Inch Woven Shorts, Oak Green, XX-Large	
B00NVRB53A	ASICS Men's Train for Sport 9-Inch Woven Shorts, Oak Green, Large	
B00NVRB5FS	ASICS Men's Train for Sport 9-Inch Woven Shorts, Oak Green, Medium	
B00NVRB54Y	ASICS Men's Train for Sport 9-Inch Woven Shorts, Oak Green, Small	
B00NVRB7U6	ASICS Men's Train for Sport 9-Inch Woven Shorts, Oak Green, X-Large	
B00NOL98X2	ASICS Men's Woven 9-Inch Short, XX-Large, Air Force Blue	
B00NOL99L8	ASICS Men's Woven 9-Inch Short, Large, Air Force Blue	
B00NOL98LY	ASICS Men's Woven 9-Inch Short, Medium, Air Force Blue	
B00NOL98O6	ASICS Men's Woven 9-Inch Short, Small, Air Force Blue	
B00NOL9HAQ	ASICS Men's Woven 9-Inch Short, X-Large, Air Force Blue	
B00NVRB7ZG	ASICS Women's Train for Sport Racerback Tank, Coralicious, Medium	
B00NVRB7YW	ASICS Women's Train for Sport Racerback Tank, Coralicious, Small	
B00NVRB81E	ASICS Women's Train for Sport Racerback Tank, Coralicious, X-Small	
B00NVRBFCG	ASICS Women's Train for Sport Racerback Tank, Performance Black Print, Large	
B00NVRBDOQ	ASICS Women's Train for Sport Racerback Tank, Performance Black Print, Medium	
B00NVRBBA2	ASICS Women's Train for Sport Racerback Tank, Performance Black Print, Small	
B00NVRBFB2	ASICS Women's Train for Sport Racerback Tank, Performance Black Print, X-Large	
B00NVRBB9S	ASICS Women's Train for Sport Racerback Tank, Performance Black Print, X-Small	
B00NVRBI0K	ASICS Women's Train for Sport Racerback Tank, Cool Mint, Medium	
B00NVRBI00	ASICS Women's Train for Sport Racerback Tank, Cool Mint, Small	
B00NVRBHY2	ASICS Women's Train for Sport Racerback Tank, Cool Mint, X-Small	
B00NVRP22A	ASICS Women's Train for Sport 2-Inch Woven Shorts, Purple Magic, Large	
B00NVRP1YE	ASICS Women's Train for Sport 2-Inch Woven Shorts, Purple Magic, Medium	
B00NVRNUSI	ASICS Women's Train for Sport 2-Inch Woven Shorts, Purple Magic, Small	
B00NVRP21G	ASICS Women's Train for Sport 2-Inch Woven Shorts, Purple Magic, X-Large	
B00NVRNURY	ASICS Women's Train for Sport 2-Inch Woven Shorts, Purple Magic, X-Small	
B00NVRP5WW	ASICS Women's Train for Sport 2-Inch Woven Shorts, Coralicious, Large	
B00NVRP61M	ASICS Women's Train for Sport 2-Inch Woven Shorts, Coralicious, Medium	
B00NVRP28Y	ASICS Women's Train for Sport 2-Inch Woven Shorts, Coralicious, Small	
B00NVRP5XG	ASICS Women's Train for Sport 2-Inch Woven Shorts, Coralicious, X-Large	
B00NVRP27U	ASICS Women's Train for Sport 2-Inch Woven Shorts, Coralicious, X-Small	
B00NVRP9N2	ASICS Women's Train for Sport 2-Inch Woven Shorts, Performance Black, Large	
B00NVRP9SM	ASICS Women's Train for Sport 2-Inch Woven Shorts, Performance Black, Medium	
B00NVRP626	ASICS Women's Train for Sport 2-Inch Woven Shorts, Performance Black, Small	
B00NVRP9QY	ASICS Women's Train for Sport 2-Inch Woven Shorts, Performance Black, X-Large	
B00NVRP5YU	ASICS Women's Train for Sport 2-Inch Woven Shorts, Performance Black, X-Small	
B00NVRPDUQ	ASICS Women's Train for Sport 2-Inch Woven Shorts, Cool Mint, Large	
B00NVRPDYW	ASICS Women's Train for Sport 2-Inch Woven Shorts, Cool Mint, Medium	
B00NVRPA0E	ASICS Women's Train for Sport 2-Inch Woven Shorts, Cool Mint, Small	
B00NVRPDZG	ASICS Women's Train for Sport 2-Inch Woven Shorts, Cool Mint, X-Large	
B00NVRPA04	ASICS Women's Train for Sport 2-Inch Woven Shorts, Cool Mint, X-Small	
B00NVRPGT4	ASICS Men's Club Graphic Short Sleeve Polo, Oak Green, Large	
B00NVRPDPQ	ASICS Men's Club Graphic Short Sleeve Polo, Oak Green, Medium	
B00NVRPDRE	ASICS Men's Club Graphic Short Sleeve Polo, Oak Green, Small	
B00NVRPGMG	ASICS Men's Club Graphic Short Sleeve Polo, Oak Green, X-Large	
B00NVRPKRM	ASICS Men's Club Graphic Short Sleeve Polo, Air Force Blue, Large	
B00NVRPGRG	ASICS Men's Club Graphic Short Sleeve Polo, Air Force Blue, Medium	
B00NVRPGS0	ASICS Men's Club Graphic Short Sleeve Polo, Air Force Blue, Small	
B00NVRPKPE	ASICS Men's Club Graphic Short Sleeve Polo, Air Force Blue, X-Large	
B00NVRPNY2	ASICS Men's Club Graphic Short Sleeve Polo, Performance Black, Large	
B00NVRPKT0	ASICS Men's Club Graphic Short Sleeve Polo, Performance Black, Medium	
B00NVRPKOA	ASICS Men's Club Graphic Short Sleeve Polo, Performance Black, Small	
B00NVRPR66	ASICS Men's Club Graphic Short Sleeve Polo, Real White, Large	
B00NVRPO14	ASICS Men's Club Graphic Short Sleeve Polo, Real White, Medium	
B00NVRPO0K	ASICS Men's Club Graphic Short Sleeve Polo, Real White, Small	
B00NVRPUPO	ASICS Men's Club Woven Shorts, Real White, XX-Large	
B00NVRPUJK	ASICS Men's Club Woven Shorts, Real White, Large	
B00NVRPRIY	ASICS Men's Club Woven Shorts, Real White, Medium	
B00NVRPRDE	ASICS Men's Club Woven Shorts, Real White, Small	
B00NVRPV12	ASICS Men's Club Woven Shorts, Real White, X-Large	
B00XV5WE96	ASICS Men's Club Woven 9" Shorts, Asphalt Blue, XX-Large	
B00NVRRFQ6	ASICS Men's Club Woven Shorts, Performance Black, XX-Large	
B00NVRQ0C6	ASICS Men's Club Woven Shorts, Performance Black, Large	
B00NVRPUR2	ASICS Men's Club Woven Shorts, Performance Black, Medium	
B00NVRPURM	ASICS Men's Club Woven Shorts, Performance Black, Small	
B00NVRQ0FI	ASICS Men's Club Woven Shorts, Performance Black, X-Large	
B00NVRRMOG	ASICS Men's Club Woven Shorts, Oak Green, XX-Large	
B00NVRRFPW	ASICS Men's Club Woven Shorts, Oak Green, Medium	
B00NVRRMS2	ASICS Men's Club Woven Shorts, Oak Green, X-Large	
B00NVRRU2A	ASICS Men's Club Woven Jacket, Real White, Large	
B00NVRRQ9C	ASICS Men's Club Woven Jacket, Real White, Medium	
B00NVRRQ38	ASICS Men's Club Woven Jacket, Real White, Small	
B00NVRRXLI	ASICS Men's Club Woven Jacket, Performance Black, Large	
B00NVRRU84	ASICS Men's Club Woven Jacket, Performance Black, Medium	
B00NVRRUE8	ASICS Men's Club Woven Jacket, Performance Black, Small	
B00NVRRXKE	ASICS Men's Club Woven Jacket, Performance Black, X-Large	
B00NVRS0N8	ASICS Men's Club Woven Jacket, Air Force Blue, Large	
B00NVRRX7C	ASICS Men's Club Woven Jacket, Air Force Blue, Medium	
B00NVRRXHW	ASICS Men's Club Woven Jacket, Air Force Blue, Small	
B00NVRS448	ASICS Men's Club Woven Pants, Real White, XX-Large	
B00NVRS434	ASICS Men's Club Woven Pants, Real White, Large	
B00NVRS0TM	ASICS Men's Club Woven Pants, Real White, Medium	
B00NVRS0LU	ASICS Men's Club Woven Pants, Real White, Small	
B00NVRS42K	ASICS Men's Club Woven Pants, Real White, X-Large	
B00NVRSAB0	ASICS Men's Club Woven Pants, Performance Black, XX-Large	
B00NVRSA38	ASICS Men's Club Woven Pants, Performance Black, Large	
B00NVRS4I4	ASICS Men's Club Woven Pants, Performance Black, Medium	
B00NVRS420	ASICS Men's Club Woven Pants, Performance Black, Small	
B00NVRSA5Q	ASICS Men's Club Woven Pants, Performance Black, X-Large	
B00NVRSDRQ	ASICS Men's Club Woven Pants, Air Force Blue, XX-Large	
B00NVRSDP8	ASICS Men's Club Woven Pants, Air Force Blue, Large	
B00NVRSAAQ	ASICS Men's Club Woven Pants, Air Force Blue, Medium	
B00NVRSAH4	ASICS Men's Club Woven Pants, Air Force Blue, Small	
B00NVRSW0Y	ASICS Men's Club Woven Pants, Air Force Blue, X-Large	
B00NVRSZ8S	ASICS Women's Club Dress, Real White, Large	
B00NVRSYXY	ASICS Women's Club Dress, Real White, Medium	
B00NVRSDQC	ASICS Women's Club Dress, Real White, Small	
B00NVRSYS4	ASICS Women's Club Dress, Real White, X-Large	
B00NVRSDW6	ASICS Women's Club Dress, Real White, X-Small	
B00NVQL4R8	ASICS Women's Club Dress, Coralicious, Large	
B00NVRT2US	ASICS Women's Club Dress, Coralicious, Medium	
B00NVRSZBK	ASICS Women's Club Dress, Coralicious, Small	
B00NVQL4GE	ASICS Women's Club Dress, Coralicious, X-Large	
B00NVRSZ1A	ASICS Women's Club Dress, Coralicious, X-Small	
B00NVQL97I	ASICS Women's Club Dress, Performance Black, Large	
B00NVQL8VK	ASICS Women's Club Dress, Performance Black, Medium	
B00NVQL8O2	ASICS Women's Club Dress, Performance Black, Small	
B00NVQL8WE	ASICS Women's Club Dress, Performance Black, X-Large	
B00NVQL4KK	ASICS Women's Club Dress, Performance Black, X-Small	
B00UR3QFN6	ASICS Women's Club Tennis Dress, Dark Cobalt, Large	
B00UR3QFYA	ASICS Women's Club Tennis Dress, Dark Cobalt, Medium	
B00UR3QFLI	ASICS Women's Club Tennis Dress, Dark Cobalt, Small	
B00UR3QFPY	ASICS Women's Club Tennis Dress, Dark Cobalt, X-Large	
B00UR3QKRW	ASICS Women's Club Tennis Dress, Dark Cobalt, X-Small	
B00NVQLCZM	ASICS Women's Club Knit Jacket, Real White, Large	
B00NVQLD6K	ASICS Women's Club Knit Jacket, Real White, Medium	
B00NVQLD7O	ASICS Women's Club Knit Jacket, Real White, Small	
B00NVQLCYS	ASICS Women's Club Knit Jacket, Real White, X-Large	
B00NVQL8JM	ASICS Women's Club Knit Jacket, Real White, X-Small	
B00NVQLGR6	ASICS Women's Club Knit Jacket, Performance Black, Large	
B00NVQLGZ8	ASICS Women's Club Knit Jacket, Performance Black, Small	
B00NVQLGSU	ASICS Women's Club Knit Jacket, Performance Black, X-Large	
B00NVQLCZW	ASICS Women's Club Knit Jacket, Performance Black, X-Small	
B00YPRSTRA	Women's ASICS Club Knit Jacket, Dark Cobalt, L	
B00YPRSW36	Women's ASICS Club Knit Jacket, Dark Cobalt, M	
B00YPRSZPQ	Women's ASICS Club Knit Jacket, Dark Cobalt, S	
B00YPRT410	Women's ASICS Club Knit Jacket, Dark Cobalt, XL	
B00YPRT7OY	Missing Detail page	
B00NVQLM1G	ASICS Women's Club Knit Pants, Real White, Large	
B00NVQLS5Q	ASICS Women's Club Knit Pants, Real White, Medium	
B00NVQLLSK	ASICS Women's Club Knit Pants, Real White, Small	
B00NVQLLSU	ASICS Women's Club Knit Pants, Real White, X-Large	
B00NVQLGNK	ASICS Women's Club Knit Pants, Real White, X-Small	
B00NVQLVM6	ASICS Women's Club Knit Pants, Performance Black, Large	
B00NVQLVXK	ASICS Women's Club Knit Pants, Performance Black, Medium	
B00NVQLVQ2	ASICS Women's Club Knit Pants, Performance Black, Small	
B00NVQLW0C	ASICS Women's Club Knit Pants, Performance Black, X-Large	
B00NVQLLUI	ASICS Women's Club Knit Pants, Performance Black, X-Small	
B00YPRTD8Y	Women's ASICS Club Knit Pant, Dark Cobalt, L	
B00YPRTFEQ	Women's ASICS Club Knit Pant, Dark Cobalt, M	
B00YPRTIXY	Women's ASICS Club Knit Pant, Dark Cobalt, S	
B00YPRTLR2	Women's ASICS Club Knit Pant, Dark Cobalt, XL	
B00YPRTQ6I	Women's ASICS Club Knit Pant, Dark Cobalt, XS	
B00KRIZGM2	ASICS Men's Train for Sport 11-Inch Woven Shorts, Performance Black/Oak Green, XX-Large	
B00KRIZHWG	ASICS Men's Train for Sport 11-Inch Woven Shorts, Performance Black/Oak Green, Large	
B00KRIZIUW	ASICS Men's Train for Sport 11-Inch Woven Shorts, Performance Black/Oak Green, Medium	
B00KRIZLVI	ASICS Men's Train for Sport 11-Inch Woven Shorts, Performance Black/Oak Green, Small	
B00KRIZNBQ	ASICS Men's Train for Sport 11-Inch Woven Shorts, Performance Black/Oak Green, X-Large	
B00NVQM4XQ	ASICS Men's Train for Sport 11-Inch Woven Shorts, Air Force Blue, XX-Large	
B00NVQM4W2	ASICS Men's Train for Sport 11-Inch Woven Shorts, Air Force Blue, Large	
B00NVQM4J0	ASICS Men's Train for Sport 11-Inch Woven Shorts, Air Force Blue, Medium	
B00NVQM13Y	ASICS Men's Train for Sport 11-Inch Woven Shorts, Air Force Blue, Small	
B00NVQM4IG	ASICS Men's Train for Sport 11-Inch Woven Shorts, Air Force Blue, X-Large	
B00NVQM986	ASICS Men's Fujitrail 5-Inch Shorts, Performance Black, XX-Large	
B00NVQM9FY	ASICS Men's Fujitrail 5-Inch Shorts, Performance Black, Large	
B00NVQM9EK	ASICS Men's Fujitrail 5-Inch Shorts, Performance Black, Medium	
B00NVQM4TA	ASICS Men's Fujitrail 5-Inch Shorts, Performance Black, Small	
B00NVQMA6W	ASICS Men's Fujitrail 5-Inch Shorts, Performance Black, X-Large	
B00NVQMDUA	ASICS Men's Fujitrail 5-Inch Shorts, Oak Green, XX-Large	
B00NVQMDUK	ASICS Men's Fujitrail 5-Inch Shorts, Oak Green, Medium	
B00NVQM9N6	ASICS Men's Fujitrail 5-Inch Shorts, Oak Green, Small	
B00NVQMDWI	ASICS Men's Fujitrail 5-Inch Shorts, Oak Green, X-Large	
B00NVQQA5O	ASICS Women's Fujitrail Graphic Top, Jeans Print, Large	
B00NVQQA5E	ASICS Women's Fujitrail Graphic Top, Jeans Print, Medium	
B00NVQQA6I	ASICS Women's Fujitrail Graphic Top, Jeans Print, Small	
B00NVQQA5Y	ASICS Women's Fujitrail Graphic Top, Jeans Print, X-Large	
B00NVQQA72	ASICS Women's Fujitrail Graphic Top, Jeans Print, X-Small	
B00NVQQC8O	ASICS Women's Fujitrail Graphic Top, Purple Magic Print, Large	
B00NVQQC5C	ASICS Women's Fujitrail Graphic Top, Purple Magic Print, Medium	
B00NVQQCA2	ASICS Women's Fujitrail Graphic Top, Purple Magic Print, Small	
B00NVQQC7K	ASICS Women's Fujitrail Graphic Top, Purple Magic Print, X-Small	
B00NVQQE78	ASICS Women's Fujitrail Graphic Top, Black Print, Large	
B00NVQQE6O	ASICS Women's Fujitrail Graphic Top, Black Print, Medium	
B00NVQQE6E	ASICS Women's Fujitrail Graphic Top, Black Print, Small	
B00NVQQE1E	ASICS Women's Fujitrail Graphic Top, Black Print, X-Large	
B00NVQQE64	ASICS Women's Fujitrail Graphic Top, Black Print, X-Small	
B00NVQQG3K	ASICS Women's Fujitrail 4-Inch Woven Shorts, Purple Magic, Large	
B00NVQQFZY	ASICS Women's Fujitrail 4-Inch Woven Shorts, Purple Magic, Medium	
B00NVQQG2Q	ASICS Women's Fujitrail 4-Inch Woven Shorts, Purple Magic, Small	
B00NVQQG5S	ASICS Women's Fujitrail 4-Inch Woven Shorts, Purple Magic, X-Large	
B00NVQQG08	ASICS Women's Fujitrail 4-Inch Woven Shorts, Purple Magic, X-Small	
B00NVQQIL0	ASICS Women's Fujitrail 4-Inch Woven Shorts, Performance Black, Large	
B00NVQQIOM	ASICS Women's Fujitrail 4-Inch Woven Shorts, Performance Black, Medium	
B00NVQQIJC	ASICS Women's Fujitrail 4-Inch Woven Shorts, Performance Black, Small	
B00NVQQIM4	ASICS Women's Fujitrail 4-Inch Woven Shorts, Performance Black, X-Large	
B00NVQQIQA	ASICS Women's Fujitrail 4-Inch Woven Shorts, Performance Black, X-Small	
B00NVQQLFI	ASICS Women's Train for Sport Bra, Coralicious, Large	
B00NVQQLBW	ASICS Women's Train for Sport Bra, Coralicious, Medium	
B00NVQQLCG	ASICS Women's Train for Sport Bra, Coralicious, Small	
B00NVQQLEE	ASICS Women's Train for Sport Bra, Coralicious, X-Small	
B00NVQQO0K	ASICS Women's Train for Sport Bra, Performance Black Print, Large	
B00NVQQNWO	ASICS Women's Train for Sport Bra, Performance Black Print, X-Small	
B00NVQQQE4	ASICS Women's Train for Sport Bra, Purple Magic Print, Large	
B00NVQQPX6	ASICS Women's Train for Sport Bra, Purple Magic Print, Medium	
B00NVQQPXG	ASICS Women's Train for Sport Bra, Purple Magic Print, Small	
B00KNEEX0G	ASICS Women's Train for Sport Styled Woven Capri, Purple Magic, Large	
B00KNEEY00	ASICS Women's Train for Sport Styled Woven Capri, Purple Magic, Medium	
B00KNEEZ3G	ASICS Women's Train for Sport Styled Woven Capri, Purple Magic, Small	
B00KNEF008	ASICS Women's Train for Sport Styled Woven Capri, Purple Magic, X-Large	
B00KNEF1IE	ASICS Women's Train for Sport Styled Woven Capri, Purple Magic, X-Small	
B00KNEEIQA	ASICS Women's Train for Sport Styled Woven Capri, Coralicious, Large	
B00KNEEK8G	ASICS Women's Train for Sport Styled Woven Capri, Coralicious, Medium	
B00KNEEM52	ASICS Women's Train for Sport Styled Woven Capri, Coralicious, Small	
B00KNEEN6K	ASICS Women's Train for Sport Styled Woven Capri, Coralicious, X-Large	
B00KNEEO4Q	ASICS Women's Train for Sport Styled Woven Capri, Coralicious, X-Small	
B00KNEEPFE	ASICS Women's Train for Sport Styled Woven Capri, Performance Black, Large	
B00KNEEQUI	ASICS Women's Train for Sport Styled Woven Capri, Performance Black, Medium	
B00KNEESJW	ASICS Women's Train for Sport Styled Woven Capri, Performance Black, Small	
B00KNEEUK4	ASICS Women's Train for Sport Styled Woven Capri, Performance Black, X-Large	
B00KNEEVDK	ASICS Women's Train for Sport Styled Woven Capri, Performance Black, X-Small	
B00KNCJ1WI	ASICS Women's Train for Sport Racerback Hoodie, Purple Magic, Large	
B00KNCJ2TU	ASICS Women's Train for Sport Racerback Hoodie, Purple Magic, Medium	
B00KNCJ3VM	ASICS Women's Train for Sport Racerback Hoodie, Purple Magic, Small	
B00KNCJ4ZW	ASICS Women's Train for Sport Racerback Hoodie, Purple Magic, X-Large	
B00KNCJ6QY	ASICS Women's Train for Sport Racerback Hoodie, Purple Magic, X-Small	
B00KNCJ7PY	ASICS Women's Train for Sport Racerback Hoodie, Cool Mint Heather, Large	
B00KNCJ8SK	ASICS Women's Train for Sport Racerback Hoodie, Cool Mint Heather, Medium	
B00KNCJ9ZW	ASICS Women's Train for Sport Racerback Hoodie, Cool Mint Heather, Small	
B00KNCJCEA	ASICS Women's Train for Sport Racerback Hoodie, Cool Mint Heather, X-Small	
