ASIN	Title
B00JBINRVG	Missing Detail page	
B00YPSF0VW	ASICS Men's Leg Balance Tights, Performance Black/Performance Black, Large	
B00YPSF3PK	ASICS Men's Leg Balance Tights, Performance Black/Performance Black, Medium	
B00YPSF81E	ASICS Men's Leg Balance Tights, Performance Black/Performance Black, X-Large	
B00NVQZBFO	ASICS Men's Leg Balance Compression Tights, Jungle Green, Large	
B00NVQZ68G	ASICS Men's Leg Balance Compression Tights, Jungle Green, Medium	
B00NVQZ668	ASICS Men's Leg Balance Compression Tights, Jungle Green, Small	
B00YPSEE32	Mens ASICS Leg Balance Tight, Indigo Blue, L	
B00YPSEH0W	Mens ASICS Leg Balance Tight, Indigo Blue, M	
B00YPSEJ00	Mens ASICS Leg Balance Tight, Indigo Blue, S	
B00YPSEL8A	Mens ASICS Leg Balance Tight, Indigo Blue, XL	
B00NVQZD8O	ASICS Men's Leg Balance Compression Tights, Air Force Blue, Large	
B00NVQZBAY	ASICS Men's Leg Balance Compression Tights, Air Force Blue, Medium	
B00NVQZB8G	ASICS Men's Leg Balance Compression Tights, Air Force Blue, Small	
B00NVQZGCM	ASICS Men's Leg Balance Compression Tights, Air Force Blue, X-Large	
B00YPSEOUK	Mens ASICS Leg Balance Tight, Black/Mosaic Blue, L	
B00YPSEQR6	Mens ASICS Leg Balance Tight, Black/Mosaic Blue, M	
B00YPSESS8	Mens ASICS Leg Balance Tight, Black/Mosaic Blue, S	
B00YPSEWUW	Mens ASICS Leg Balance Tight, Black/Mosaic Blue, XL	
B00YPSE22U	Mens ASICS Leg Balance Knee Tight, Black/Safety Yellow, L	
B00YPSE4D2	Mens ASICS Leg Balance Knee Tight, Black/Safety Yellow, M	
B00YPSE6DU	Mens ASICS Leg Balance Knee Tight, Black/Safety Yellow, S	
B00YPSE8EW	Mens ASICS Leg Balance Knee Tight, Black/Safety Yellow, XL	
B00YPSDR44	ASICS Men's Leg Balance Knee Tights Performance Black/Fiery Flame LG X 15	
B00YPSDT74	ASICS Men's Leg Balance Knee Tights Performance Black/Fiery Flame MD X 15	
B00YPSDVAE	ASICS Men's Leg Balance Knee Tights Performance Black/Fiery Flame SM X 15	
B00YPSDXT8	ASICS Men's Leg Balance Knee Tights Performance Black/Fiery Flame XL X 15	
B00YPRRRXW	Womens ASICS Leg Balance Knee Tight, Black/Pink Glow, L	
B00YPRRW82	Womens ASICS Leg Balance Knee Tight, Black/Pink Glow, M	
B00YPRSC8Q	Womens ASICS Leg Balance Knee Tight, Black/Pink Glow, S	
B00YPRSF3S	Womens ASICS Leg Balance Knee Tight, Black/Pink Glow, XL	
B00YPRSIEE	Womens ASICS Leg Balance Knee Tight, Black/Pink Glow, XS	
B00YPRR9YY	ASICS Women's Leg Balance Knee Tights, Performance Black/Performance Black, Large	
B00YPRRCNC	ASICS Women's Leg Balance Knee Tights, Performance Black/Performance Black, Medium	
B00YPRRFEI	ASICS Women's Leg Balance Knee Tights, Performance Black/Performance Black, Small	
B00YPRRK34	ASICS Women's Leg Balance Knee Tights, Performance Black/Performance Black, X-Large	
B00YPRRMVY	ASICS Women's Leg Balance Knee Tights, Performance Black/Performance Black, X-Small	
B00NVQZGC2	ASICS Women's Leg Balance Compression Knee Tights, Balance Black, Medium	
B00NVQZGQ8	ASICS Women's Leg Balance Compression Knee Tights, Balance Black, Small	
B00NVQZGAE	ASICS Women's Leg Balance Compression Knee Tights, Balance Black, X-Small	
B00YPRQETA	ASICS Women's Leg Balance Knee Tights Perforated Black/Aqua Mint LG (US 10-12) X 16	
B00YPRQHM4	ASICS Women's Leg Balance Knee Tights Perforated Black/Aqua Mint MD (US 8-10) X 16	
B00YPRQL9I	ASICS Women's Leg Balance Knee Tights Perforated Black/Aqua Mint SM (US 6-8) X 16	
B00YPRQNVO	ASICS Women's Leg Balance Knee Tights Perforated Black/Aqua Mint XL (US 12-14) X 16	
B00YPRQQTI	ASICS Women's Leg Balance Knee Tights Perforated Black/Aqua Mint XS (US 4-6) X 16	
B00YPRQU62	Womens ASICS Leg Balance Knee Tight, Black/Deep Ruby, L	
B00YPRQXH8	Womens ASICS Leg Balance Knee Tight, Black/Deep Ruby, M	
B00YPRR0MK	Womens ASICS Leg Balance Knee Tight, Black/Deep Ruby, S	
B00YPRR3RC	Womens ASICS Leg Balance Knee Tight, Black/Deep Ruby, XL	
B00YPRR6UG	Womens ASICS Leg Balance Knee Tight, Black/Deep Ruby, XS	
B00NVQZKF0	ASICS Women's Leg Balance Compression Tights, Fizzy Peach, Large	
B00NVQZKK0	ASICS Women's Leg Balance Compression Tights, Fizzy Peach, Medium	
B00NVQZKBY	ASICS Women's Leg Balance Compression Tights, Fizzy Peach, Small	
B00NVQZK9Q	ASICS Women's Leg Balance Compression Tights, Fizzy Peach, X-Small	
B00YPSKR60	ASICS® Women's Leg Balance® Tight Performance Black/Performance Black L none	
B00YPSKTJA	ASICS® Women's Leg Balance® Tight Performance Black/Performance Black M none	
B00YPSKVW0	ASICS Women's Leg Balance Tights Perforated Black/Living Coral Pants SM (US 6-8)	
B00YPSKYFY	ASICS® Women's Leg Balance® Tight Performance Black/Performance Black XL none	
B00YPSL0CK	ASICS® Women's Leg Balance® Tight Performance Black/Performance Black XS none	
B00YPSLRFA	Women's ASICS Leg Balance Tight, Black/Pink Glow, M	
B00YPSLTEY	Asics Womens Leg Balance Tight, S	
B00YPSLVPQ	Women's ASICS Leg Balance Tight, Black/Pink Glow, XL	
B00YPSLY6M	Women's ASICS Leg Balance Tight, Black/Pink Glow, XS	
B00NVQZP3M	ASICS Women's Leg Balance Compression Tights, Jeans, Large	
B00NVQZP1O	ASICS Women's Leg Balance Compression Tights, Jeans, Medium	
B00NVQZPQE	ASICS Women's Leg Balance Compression Tights, Jeans, Small	
B00NVQZTCE	ASICS Women's Leg Balance Compression Tights, Jeans, X-Large	
B00YPSL2XM	ASICS Women's Leg Balance Tights, Performance Black/Performance Black, Large	
B00YPSL6TC	ASICS Women's Leg Balance Tights, Performance Black/Performance Black, Medium	
B00YPSL8ZY	ASICS Women's Leg Balance Tights, Performance Black/Performance Black, Small	
B00YPSLAXY	ASICS Women's Leg Balance Tights, Performance Black/Performance Black, X-Large	
B00YPSLMK0	ASICS Women's Leg Balance Tights, Performance Black/Performance Black, X-Small	
B00YPSKFKI	Women's ASICS Leg Balance Tight, Black/Aqua Mint, L	
B00YPSKHWY	Women's ASICS Leg Balance Tight, Black/Aqua Mint, M	
B00YPSKKCQ	Asics Womens Leg Balance Tight, S	
B00YPSKM2O	Women's ASICS Leg Balance Tight, Black/Aqua Mint, XL	
B00YPSKORM	Women's ASICS Leg Balance Tight, Black/Aqua Mint, XS	
B00NVQZYTW	ASICS Women's Speed Short Sleeve Stripe Top, Ultra Pink, Large	
B00NVQZYQ0	ASICS Women's Speed Short Sleeve Stripe Top, Ultra Pink, Medium	
B00NVQZYT2	ASICS Women's Speed Short Sleeve Stripe Top, Ultra Pink, Small	
B00NVR011W	ASICS Women's Speed Short Sleeve Stripe Top, Ultra Pink, X-Large	
B00NVQZYQU	ASICS Women's Speed Short Sleeve Stripe Top, Ultra Pink, X-Small	
B00NVR018A	ASICS Women's Speed Short Sleeve Stripe Top, Fizzy Peach, Large	
B00NVR010I	ASICS Women's Speed Short Sleeve Stripe Top, Fizzy Peach, Medium	
B00NVR012G	ASICS Women's Speed Short Sleeve Stripe Top, Fizzy Peach, Small	
B00NVR03DS	ASICS Women's Speed Short Sleeve Stripe Top, Fizzy Peach, X-Large	
B00NVR016M	ASICS Women's Speed Short Sleeve Stripe Top, Fizzy Peach, X-Small	
B00NVR03HO	ASICS Women's Speed Short Sleeve Stripe Top, Jeans, Large	
B00NVR03CE	ASICS Women's Speed Short Sleeve Stripe Top, Jeans, Medium	
B00NVR03GK	ASICS Women's Speed Short Sleeve Stripe Top, Jeans, Small	
B00NVR06QW	ASICS Women's Speed Short Sleeve Stripe Top, Jeans, X-Large	
B00NVR03H4	ASICS Women's Speed Short Sleeve Stripe Top, Jeans, X-Small	
B00O3XNQ88	Asics Stripe Women's Short Sleeve Running Top L Balance Black	
B00O3XNP48	Asics 2015 Women's Stripe Top Short Sleeve Running Shirt - 121331 (Balance Black - M) Size M,M	
B00O3XNCBE	Asics 2015 Women's Stripe Top Short Sleeve Running Shirt - 121331 (Balance Black - S) Size S,S	
B00O3XNRBE	Asics 2015 Women's Stripe Top Short Sleeve Running Shirt - 121331 (Balance Black - XL) Size XL,XL	
B00O3XNA6Q	Asics 2015 Women's Stripe Top Short Sleeve Running Shirt - 121331 (Balance Black - XS) Size XS,XS	
B00NVR5MWK	ASICS Women's Speed Stripes Knee Tights, Fizzy Peach, Large	
B00NVR5N1A	ASICS Women's Speed Stripes Knee Tights, Fizzy Peach, Medium	
B00NVR5HQG	ASICS Women's Speed Stripes Knee Tights, Fizzy Peach, Small	
B00NVR5N1K	ASICS Women's Speed Stripes Knee Tights, Fizzy Peach, X-Large	
B00NVR5HR0	ASICS Women's Speed Stripes Knee Tights, Fizzy Peach, X-Small	
B00NVR5PUO	ASICS Women's Speed Stripes Knee Tights, Cherry Tomato, Large	
B00NVR5Q94	ASICS Women's Speed Stripes Knee Tights, Cherry Tomato, Medium	
B00NVR5N56	ASICS Women's Speed Stripes Knee Tights, Cherry Tomato, Small	
B00NVR5P2C	ASICS Women's Speed Stripes Knee Tights, Cherry Tomato, X-Large	
B00NVR5MUC	ASICS Women's Speed Stripes Knee Tights, Cherry Tomato, X-Small	
B00NVR5S42	ASICS Women's Speed Stripes Knee Tights, Jeans, Large	
B00NVR5RUM	ASICS Women's Speed Stripes Knee Tights, Jeans, Medium	
B00NVR5P5E	ASICS Women's Speed Stripes Knee Tights, Jeans, Small	
B00NVR5S7O	ASICS Women's Speed Stripes Knee Tights, Jeans, X-Large	
B00NVR5OXW	ASICS Women's Speed Stripes Knee Tights, Jeans, X-Small	
B00NVR5U2C	ASICS Men's Speed Singlet, Green Gecko, XX-Large	
B00NVR5U4K	ASICS Men's Speed Singlet, Green Gecko, Large	
B00NVR5S2E	ASICS Men's Speed Singlet, Green Gecko, Medium	
B00NVR5S4C	ASICS Men's Speed Singlet, Green Gecko, Small	
B00NVR5U8Q	ASICS Men's Speed Singlet, Green Gecko, X-Large	
B00NVR5X92	ASICS Men's Speed Singlet, Air Force Blue, XX-Large	
B00NVR5X4C	ASICS Men's Speed Singlet, Air Force Blue, Large	
B00NVR5UN6	ASICS Men's Speed Singlet, Air Force Blue, Medium	
B00NVR5UQ8	ASICS Men's Speed Singlet, Air Force Blue, Small	
B00NVR5X3S	ASICS Men's Speed Singlet, Air Force Blue, X-Large	
B00NVR606C	ASICS Men's Speed Short Sleeve Top, Green Gecko, XX-Large	
B00NVR60GM	ASICS Men's Speed Short Sleeve Top, Green Gecko, Large	
B00NVR5X5Q	ASICS Men's Speed Short Sleeve Top, Green Gecko, Medium	
B00NVR607Q	ASICS Men's Speed Short Sleeve Top, Green Gecko, X-Large	
B00NVR62I8	ASICS Men's Speed Short Sleeve Top, Shocking Orange, XX-Large	
B00NVR62G0	ASICS Men's Speed Short Sleeve Top, Shocking Orange, Large	
B00NVR602G	ASICS Men's Speed Short Sleeve Top, Shocking Orange, Medium	
B00NVR6012	ASICS Men's Speed Short Sleeve Top, Shocking Orange, Small	
B00NVR62GU	ASICS Men's Speed Short Sleeve Top, Shocking Orange, X-Large	
B00NVR64IG	ASICS Men's Speed Short Sleeve Top, Air Force Blue, XX-Large	
B00NVR68MI	ASICS Men's Speed Split Shorts, Performance Black, XX-Large	
B00NVR686E	ASICS Men's Speed Split Shorts, Performance Black, Large	
B00NVR681E	ASICS Men's Speed Split Shorts, Performance Black, X-Large	
B00NVRGZ2Q	ASICS Men's Speed Split Shorts, Performance Black/Jungle Green, XX-Large	
B00NVR6SG4	ASICS Men's Speed Split Shorts, Performance Black/Jungle Green, Large	
B00NVR68B4	ASICS Men's Speed Split Shorts, Performance Black/Jungle Green, Medium	
B00NVR680K	ASICS Men's Speed Split Shorts, Performance Black/Jungle Green, Small	
B00NVR6SP0	ASICS Men's Speed Split Shorts, Performance Black/Jungle Green, X-Large	
B00NVRH2FU	ASICS Men's Speed Split Shorts, Air Force Blue, XX-Large	
B00NVRH25U	ASICS Men's Speed Split Shorts, Air Force Blue, Large	
B00NVRH27I	ASICS Men's Speed Split Shorts, Air Force Blue, X-Large	
B00UG42X46	Missing Detail page	
B00NVRHCZK	ASICS Women's Speed Allover Print Tank Top, Fizzy Peach, Large	
B00NVRHD6S	ASICS Women's Speed Allover Print Tank Top, Fizzy Peach, Medium	
B00NVRHKLQ	ASICS Women's Speed Allover Print Tank Top, Fizzy Peach, Small	
B00NVRHDAE	ASICS Women's Speed Allover Print Tank Top, Fizzy Peach, X-Large	
B00NVRHD0Y	ASICS Women's Speed Allover Print Tank Top, Fizzy Peach, X-Small	
B00NVRHNLI	ASICS Women's Speed Allover Print Tank Top, Natural Blue, Large	
B00NVRHNQ8	ASICS Women's Speed Allover Print Tank Top, Natural Blue, Medium	
B00NVRHNFY	ASICS Women's Speed Allover Print Tank Top, Natural Blue, Small	
B00NVRHNF4	ASICS Women's Speed Allover Print Tank Top, Natural Blue, X-Large	
B00NVRHNI6	ASICS Women's Speed Allover Print Tank Top, Natural Blue, X-Small	
B00NVRHQ74	ASICS Women's Speed Short Sleeve Top, Fizzy Peach, Large	
B00NVRHQ7E	ASICS Women's Speed Short Sleeve Top, Fizzy Peach, Medium	
B00NVRHQ6A	ASICS Women's Speed Short Sleeve Top, Fizzy Peach, Small	
B00NVRHQDI	ASICS Women's Speed Short Sleeve Top, Fizzy Peach, X-Large	
B00NVRHQBU	ASICS Women's Speed Short Sleeve Top, Fizzy Peach, X-Small	
B00NVRHT26	ASICS Women's Speed Short Sleeve Top, Jeans, Large	
B00NVRHTA8	ASICS Women's Speed Short Sleeve Top, Jeans, Medium	
B00NVRHT3U	ASICS Women's Speed Short Sleeve Top, Jeans, Small	
B00NVRHTAS	ASICS Women's Speed Short Sleeve Top, Jeans, X-Large	
B00NVRHT44	ASICS Women's Speed Short Sleeve Top, Jeans, X-Small	
B00NVRHZVG	ASICS Men's Performance Run Sleeveless Top, Jungle Green, XX-Large	
B00NVRI01U	ASICS Men's Performance Run Sleeveless Top, Jungle Green, Large	
B00NVRI02E	ASICS Men's Performance Run Sleeveless Top, Jungle Green, Medium	
B00NVRI0G0	ASICS Men's Performance Run Sleeveless Top, Jungle Green, Small	
B00NVRI0JM	ASICS Men's Performance Run Sleeveless Top, Jungle Green, X-Large	
B00NVRI830	ASICS Men's Performance Run Sleeveless Top, Air Force Blue, Large	
B00NVRI84E	ASICS Men's Performance Run Sleeveless Top, Air Force Blue, Medium	
B00NVRI858	ASICS Men's Performance Run Sleeveless Top, Air Force Blue, X-Large	
B00NVRIE34	ASICS Men's Performance Run Graphic Short Sleeve Top, Skyline Green Gecko, XX-Large	
B00NVRIEES	ASICS Men's Performance Run Graphic Short Sleeve Top, Skyline Green Gecko, Large	
B00NVRIE70	ASICS Men's Performance Run Graphic Short Sleeve Top, Skyline Green Gecko, Medium	
B00NVRIE16	ASICS Men's Performance Run Graphic Short Sleeve Top, Skyline Green Gecko, Small	
B00NVRIE52	ASICS Men's Performance Run Graphic Short Sleeve Top, Skyline Green Gecko, X-Large	
B00NVRJOG0	ASICS Men's Performance Run Graphic Short Sleeve Top, Skyline Jungle Green, XX-Large	
B00NVRJOJC	ASICS Men's Performance Run Graphic Short Sleeve Top, Skyline Jungle Green, Large	
B00NVRIHI6	ASICS Men's Performance Run Graphic Short Sleeve Top, Skyline Jungle Green, Medium	
B00NVRIOHK	ASICS Men's Performance Run Graphic Short Sleeve Top, Skyline Jungle Green, Small	
B00NVRJOEW	ASICS Men's Performance Run Graphic Short Sleeve Top, Skyline Jungle Green, X-Large	
B00NVRJRDA	ASICS Men's Performance Run Graphic Short Sleeve Top, Skyline Atomic Blue, XX-Large	
B00NVRJRQW	ASICS Men's Performance Run Graphic Short Sleeve Top, Skyline Atomic Blue, Large	
B00NVRJSK2	ASICS Men's Performance Run Graphic Short Sleeve Top, Skyline Atomic Blue, Medium	
B00NVRJO7Y	ASICS Men's Performance Run Graphic Short Sleeve Top, Skyline Atomic Blue, Small	
B00NVRJRIK	ASICS Men's Performance Run Graphic Short Sleeve Top, Skyline Atomic Blue, X-Large	
B00NVRJUWS	ASICS Men's Performance Run Graphic Short Sleeve Top, Skyline Air Force, Large	
B00NVRJV4K	ASICS Men's Performance Run Graphic Short Sleeve Top, Skyline Air Force, Medium	
B00NVRJRG2	ASICS Men's Performance Run Graphic Short Sleeve Top, Skyline Air Force, Small	
B00NVRJV86	ASICS Men's Performance Run Graphic Short Sleeve Top, Skyline Air Force, X-Large	
B00NVRK284	ASICS Men's Performance Run Graphic Short Sleeve Top, Skyline Performance Black, Large	
B00NVRK1NA	ASICS Men's Performance Run Graphic Short Sleeve Top, Skyline Performance Black, Medium	
B00NVRJVHW	ASICS Men's Performance Run Graphic Short Sleeve Top, Skyline Performance Black, Small	
B00NVRKEWS	ASICS Men's Speed Stripes Short Sleeve Top, Safety Yellow, Large	
B00NVRKENC	ASICS Men's Speed Stripes Short Sleeve Top, Safety Yellow, Medium	
B00NVRKBOY	ASICS Men's Speed Stripes Short Sleeve Top, Safety Yellow, Small	
B00NVRKEOQ	ASICS Men's Speed Stripes Short Sleeve Top, Safety Yellow, X-Large	
B00NVRKI1A	ASICS Men's Speed Stripes Short Sleeve Top, Shocking Orange, Large	
B00NVRKIG0	ASICS Men's Speed Stripes Short Sleeve Top, Shocking Orange, Medium	
B00NVRKEUU	ASICS Men's Speed Stripes Short Sleeve Top, Shocking Orange, Small	
B00NVRKI3I	ASICS Men's Speed Stripes Short Sleeve Top, Shocking Orange, X-Large	
B00NVRKLYY	ASICS Men's Speed Stripes Short Sleeve Top, Performance Black, XX-Large	
B00NVRKLUS	ASICS Men's Speed Stripes Short Sleeve Top, Performance Black, Large	
B00NVRKM2U	ASICS Men's Speed Stripes Short Sleeve Top, Performance Black, Medium	
B00NVRKHYI	ASICS Men's Speed Stripes Short Sleeve Top, Performance Black, Small	
B00NVRKM52	ASICS Men's Speed Stripes Short Sleeve Top, Performance Black, X-Large	
B00NVRKOW8	ASICS Men's Speed Stripes Short Sleeve Top, Jungle Green, Large	
B00NVRKP7C	ASICS Men's Speed Stripes Short Sleeve Top, Jungle Green, Medium	
B00NVRKM5C	ASICS Men's Speed Stripes Short Sleeve Top, Jungle Green, Small	
B00NVRKP7M	ASICS Men's Speed Stripes Short Sleeve Top, Jungle Green, X-Large	
B00KNEGFMK	ASICS Men's Performance Run Hooded Long Sleeve Top, Performance Black Heather, XX-Large	
B00KNEGHDM	ASICS Men's Performance Run Hooded Long Sleeve Top, Performance Black Heather, Large	
B00KNEGN36	ASICS Men's Performance Run Hooded Long Sleeve Top, Jungle Green Heather, XX-Large	
B00KNEGOTY	ASICS Men's Performance Run Hooded Long Sleeve Top, Jungle Green Heather, Large	
B00KNEGQL0	ASICS Men's Performance Run Hooded Long Sleeve Top, Jungle Green Heather, Medium	
B00KNEGS7M	ASICS Men's Performance Run Hooded Long Sleeve Top, Jungle Green Heather, Small	
B00KNEGTTE	ASICS Men's Performance Run Hooded Long Sleeve Top, Jungle Green Heather, X-Large	
B00KNEGWJ6	ASICS Men's Performance Run Hooded Long Sleeve Top, Air Force Blue Heather, Large	
B00KNEGXQS	ASICS Men's Performance Run Hooded Long Sleeve Top, Air Force Blue Heather, Medium	
B00KNEGZUM	ASICS Men's Performance Run Hooded Long Sleeve Top, Air Force Blue Heather, X-Large	
B00NVRM3F4	ASICS Men's Performance Run Lightweight Jacket, Skyline Jungle Green, XX-Large	
B00NVRM3BI	ASICS Men's Performance Run Lightweight Jacket, Skyline Jungle Green, Large	
B00NVRM3EU	ASICS Men's Performance Run Lightweight Jacket, Skyline Jungle Green, Medium	
B00NVRM0LQ	ASICS Men's Performance Run Lightweight Jacket, Skyline Jungle Green, Small	
B00NVRM3PO	ASICS Men's Performance Run Lightweight Jacket, Skyline Jungle Green, X-Large	
B00NVRM6HO	ASICS Men's Performance Run Lightweight Jacket, Skyline Air Force, Large	
B00NVRM3C2	ASICS Men's Performance Run Lightweight Jacket, Skyline Air Force, Small	
B00NVRM9DU	ASICS Men's Performance Run Lightweight Jacket, Skyline Performance Black, Large	
B00NVRM9YY	ASICS Men's Performance Run Lightweight Jacket, Skyline Performance Black, Medium	
B00KNE3F1E	ASICS Men's Performance Run 7-Inch Woven Shorts with Reflective Dots, Performance Black, XX-Large	
B00KNE3HFS	ASICS Men's Performance Run 7-Inch Woven Shorts with Reflective Dots, Performance Black, Large	
B00KNE3JDI	ASICS Men's Performance Run 7-Inch Woven Shorts with Reflective Dots, Performance Black, Medium	
B00KNE3LOU	ASICS Men's Performance Run 7-Inch Woven Shorts with Reflective Dots, Performance Black, Small	
B00KNE3NXO	ASICS Men's Performance Run 7-Inch Woven Shorts with Reflective Dots, Performance Black, X-Large	
B00KNE3S48	ASICS Men's Performance Run 7-Inch Woven Shorts with Reflective Dots, Skyline Atomic Blue, XX-Large	
B00KNE3U14	ASICS Men's Performance Run 7-Inch Woven Shorts with Reflective Dots, Skyline Atomic Blue, Large	
B00KNE3WTE	ASICS Men's Performance Run 7-Inch Woven Shorts with Reflective Dots, Skyline Atomic Blue, Medium	
B00KNE40FY	ASICS Men's Performance Run 7-Inch Woven Shorts with Reflective Dots, Skyline Atomic Blue, Small	
B00KNE44XC	ASICS Men's Performance Run 7-Inch Woven Shorts with Reflective Dots, Skyline Atomic Blue, X-Large	
B00KNE347Y	ASICS Men's Performance Run 7-Inch Woven Shorts with Reflective Dots, Skyline Performance Black, XX-Large	
B00KNE35FA	ASICS Men's Performance Run 7-Inch Woven Shorts with Reflective Dots, Skyline Performance Black, Large	
B00KNE3CT4	ASICS Men's Performance Run 7-Inch Woven Shorts with Reflective Dots, Skyline Performance Black, X-Large	
B00YPSF788	ASICS 121632 Men's Woven Short 9, Dark Grey Pixel, XXL	
B00YPSEZ9K	ASICS 121632 Men's Woven Short 9, Dark Grey Pixel, L	
B00YPSF12A	ASICS 121632 Men's Woven Short 9, Dark Grey Pixel, M	
B00YPSF41I	ASICS 121632 Men's Woven Short 9, Dark Grey Pixel, S	
B00YPSF5LW	ASICS 121632 Men's Woven Short 9, Dark Grey Pixel, XL	
B00YPSFKI0	ASICS 121632 Men's Woven Short 9, Indigo Blue Pixel, XXL	
B00YPSF8O6	ASICS 121632 Men's Woven Short 9, Indigo Blue Pixel, L	
B00YPSFACQ	ASICS 121632 Men's Woven Short 9, Indigo Blue Pixel, M	
B00YPSFGQG	ASICS 121632 Men's Woven Short 9, Indigo Blue Pixel, S	
B00YPSFINM	ASICS 121632 Men's Woven Short 9, Indigo Blue Pixel, XL	
B00YPSFTUE	ASICS 121632 Men's Woven Short 9, Black Pixel, XXL	
B00YPSFMD8	ASICS 121632 Men's Woven Short 9, Black Pixel, L	
B00YPSFOGI	ASICS 121632 Men's Woven Short 9, Black Pixel, M	
B00YPSFQ7A	ASICS 121632 Men's Woven Short 9, Black Pixel, S	
B00YPSFS4G	ASICS 121632 Men's Woven Short 9, Black Pixel, XL	
B00NVRMIRW	ASICS Men's Performance Run 2-N-1 9-Inch Shorts, Performance Black, XX-Large	
B00NVRMIWC	ASICS Men's Performance Run 2-N-1 9-Inch Shorts, Performance Black, Large	
B00NVRMFXE	ASICS Men's Performance Run 2-N-1 9-Inch Shorts, Performance Black, Small	
B00NVRMJ2Q	ASICS Men's Performance Run 2-N-1 9-Inch Shorts, Performance Black, X-Large	
B00KN80AWC	ASICS Women's Performance Run Short Sleeve T-Shirt, Ultra Pink Heather, Large	
B00KN80DAG	ASICS Women's Performance Run Short Sleeve T-Shirt, Ultra Pink Heather, Medium	
B00KN80FIQ	ASICS Women's Performance Run Short Sleeve T-Shirt, Ultra Pink Heather, Small	
B00KN80JIC	ASICS Women's Performance Run Short Sleeve T-Shirt, Ultra Pink Heather, X-Small	
B00KN80L9E	ASICS Women's Performance Run Short Sleeve T-Shirt, Heather Grey, Large	
B00KN80N4C	ASICS Women's Performance Run Short Sleeve T-Shirt, Heather Grey, Medium	
B00KN80QIA	ASICS Women's Performance Run Short Sleeve T-Shirt, Heather Grey, Small	
B00KN80W9S	ASICS Women's Performance Run Short Sleeve T-Shirt, Heather Grey, X-Small	
B00NVQJ00G	ASICS Women's Performance Run Short Sleeve T-Shirt, Cherry Tomato Heather, Large	
B00NVQIZV6	ASICS Women's Performance Run Short Sleeve T-Shirt, Cherry Tomato Heather, Medium	
B00NVQJ02E	ASICS Women's Performance Run Short Sleeve T-Shirt, Cherry Tomato Heather, Small	
B00NVQJ2G8	ASICS Women's Performance Run Short Sleeve T-Shirt, Cherry Tomato Heather, X-Large	
B00NVQIZUW	ASICS Women's Performance Run Short Sleeve T-Shirt, Cherry Tomato Heather, X-Small	
B00NVQJ4PM	ASICS Women's Performance Run Graphic Top, Heather Grey, Medium	
B00NVQJ4Z2	ASICS Women's Performance Run Graphic Top, Heather Grey, Small	
B00NVQJ4WA	ASICS Women's Performance Run Graphic Top, Heather Grey, X-Large	
B00NVQJ7O0	ASICS Women's Performance Run Graphic Top, Performance Black, Medium	
B00U2J7UL6	ASICS Women's Allover Graphic Top, Large, Mosaic Blue Palm	
B00U2J7UO8	ASICS Women's Allover Graphic Top, Medium, Mosaic Blue Palm	
B00U2J7ULG	ASICS Women's Allover Graphic Top, Small, Mosaic Blue Palm	
B00U2J7UKM	ASICS Women's Allover Graphic Top, X-Large, Mosaic Blue Palm	
B00U2J7X22	ASICS Women's Allover Graphic Top, X-Small, Mosaic Blue Palm	
B00U2J7WWS	ASICS Women's Allover Graphic Top, Medium, Pink Glow Palm	
B00U2J7X4K	ASICS Women's Allover Graphic Top, X-Small, Pink Glow Palm	
B00YPS4I6U	Womens ASICS Allover Graphic Top, Living Coral Palm, L	
B00YPS4JZK	Womens ASICS Allover Graphic Top, Living Coral Palm, M	
B00YPS4MGG	Womens ASICS Allover Graphic Top, Living Coral Palm, S	
B00YPS4OU0	Womens ASICS Allover Graphic Top, Living Coral Palm, XL	
B00YPS4QYY	Womens ASICS Allover Graphic Top, Living Coral Palm, XS	
B00U2J7X1S	ASICS Women's Allover Graphic Top, Large, Deep Ruby Palm	
B00U2J7ZIO	ASICS Women's Allover Graphic Top, Medium, Deep Ruby Palm	
B00U2J7ZH0	ASICS Women's Allover Graphic Top, Small, Deep Ruby Palm	
B00U2J7ZMA	ASICS Women's Allover Graphic Top, X-Large, Deep Ruby Palm	
B00U2J7ZK2	ASICS Women's Allover Graphic Top, X-Small, Deep Ruby Palm	
B00U2J7ZJ8	ASICS Women's Allover Graphic Top, Medium, Black Palm	
B00U2J7ZNE	ASICS Women's Allover Graphic Top, Small, Black Palm	
B00U2J8222	ASICS Women's Allover Graphic Top, X-Small, Black Palm	
B00NVQJAHE	ASICS Women's Performance Run Lightweight Jacket, Performance Black Cloud, Medium	
B00NVQJAMO	ASICS Women's Performance Run Lightweight Jacket, Performance Black Cloud, X-Large	
B00NVQJAJW	ASICS Women's Performance Run Lightweight Jacket, Performance Black Cloud, X-Small	
B00NVQJDB2	ASICS Men's Fujitrail Sleeveless Top, Purple Acai Heather, XX-Large	
B00NVQJDGC	ASICS Men's Fujitrail Sleeveless Top, Purple Acai Heather, Large	
B00NVQJDG2	ASICS Men's Fujitrail Sleeveless Top, Purple Acai Heather, Medium	
B00NVQJD4E	ASICS Men's Fujitrail Sleeveless Top, Purple Acai Heather, Small	
B00NVQJDF8	ASICS Men's Fujitrail Sleeveless Top, Purple Acai Heather, X-Large	
B00NVQJFW4	ASICS Men's Fujitrail Sleeveless Top, Shocking Orange Heather, XX-Large	
B00NVQJFSI	ASICS Men's Fujitrail Sleeveless Top, Shocking Orange Heather, Large	
B00NVQJG0K	ASICS Men's Fujitrail Sleeveless Top, Shocking Orange Heather, Medium	
B00NVQJFRO	ASICS Men's Fujitrail Sleeveless Top, Shocking Orange Heather, Small	
B00NVQJFVU	ASICS Men's Fujitrail Sleeveless Top, Shocking Orange Heather, X-Large	
B00NVQJIU8	ASICS Men's Fujitrail Sleeveless Top, Performance Black, XX-Large	
B00NVQJJPW	ASICS Men's Fujitrail Sleeveless Top, Performance Black, Large	
B00NVQJITE	ASICS Men's Fujitrail Sleeveless Top, Performance Black, Medium	
B00NVQJIWG	ASICS Men's Fujitrail Sleeveless Top, Performance Black, Small	
B00NVQJISA	ASICS Men's Fujitrail Sleeveless Top, Performance Black, X-Large	
B00NVQJME0	ASICS Men's Fujitrail Sleeveless Top, Oak Green Heather, XX-Large	
B00NVQJMA4	ASICS Men's Fujitrail Sleeveless Top, Oak Green Heather, Large	
B00NVQJM7M	ASICS Men's Fujitrail Sleeveless Top, Oak Green Heather, Medium	
B00NVQJM9U	ASICS Men's Fujitrail Sleeveless Top, Oak Green Heather, Small	
B00NVQJMFO	ASICS Men's Fujitrail Sleeveless Top, Oak Green Heather, X-Large	
B00NVQJOTS	ASICS Men's Fujitrail Light Top, Black Print, XX-Large	
B00NVQJOT8	ASICS Men's Fujitrail Light Top, Black Print, Large	
B00NVQJP0G	ASICS Men's Fujitrail Light Top, Black Print, Medium	
B00NVQJOOI	ASICS Men's Fujitrail Light Top, Black Print, Small	
B00NVQJOWA	ASICS Men's Fujitrail Light Top, Black Print, X-Large	
B00NVQNVOC	ASICS Men's Fujitrail Light Top, Green Gecko Print, XX-Large	
B00NVQJRP4	ASICS Men's Fujitrail Light Top, Green Gecko Print, Large	
B00NVQJRRM	ASICS Men's Fujitrail Light Top, Green Gecko Print, Medium	
B00NVQJRQI	ASICS Men's Fujitrail Light Top, Green Gecko Print, Small	
B00NVQJSBW	ASICS Men's Fujitrail Light Top, Green Gecko Print, X-Large	
B00NVQNYQC	ASICS Men's Fujitrail Light Top, Purple Acai Print, XX-Large	
B00NVQNY6C	ASICS Men's Fujitrail Light Top, Purple Acai Print, Large	
B00NVQNY62	ASICS Men's Fujitrail Light Top, Purple Acai Print, Medium	
B00NVQNTKI	ASICS Men's Fujitrail Light Top, Purple Acai Print, Small	
B00NVQNYAS	ASICS Men's Fujitrail Light Top, Purple Acai Print, X-Large	
B00NVQO2ZY	ASICS Men's Fujitrail Hoodie, Purple Acai Heather, XX-Large	
B00NVQO2YU	ASICS Men's Fujitrail Hoodie, Purple Acai Heather, Large	
B00NVQO3DK	ASICS Men's Fujitrail Hoodie, Purple Acai Heather, Medium	
B00NVQNXYK	ASICS Men's Fujitrail Hoodie, Purple Acai Heather, Small	
B00NVQO2ZO	ASICS Men's Fujitrail Hoodie, Purple Acai Heather, X-Large	
B00NVQO5SS	ASICS Men's Fujitrail Hoodie, Heather Grey, XX-Large	
B00NVQO5NS	ASICS Men's Fujitrail Hoodie, Heather Grey, Large	
B00NVQO5WE	ASICS Men's Fujitrail Hoodie, Heather Grey, Medium	
B00NVQO2Z4	ASICS Men's Fujitrail Hoodie, Heather Grey, Small	
B00NVQO5Q0	ASICS Men's Fujitrail Hoodie, Heather Grey, X-Large	
B00NVQO8LC	ASICS Men's Fujitrail Hoodie, Performance Black Heather, XX-Large	
B00NVQO8KI	ASICS Men's Fujitrail Hoodie, Performance Black Heather, Large	
B00NVQO8K8	ASICS Men's Fujitrail Hoodie, Performance Black Heather, Medium	
B00NVQO5YM	ASICS Men's Fujitrail Hoodie, Performance Black Heather, Small	
B00NVQO8JE	ASICS Men's Fujitrail Hoodie, Performance Black Heather, X-Large	
B00NVQOEWK	ASICS Men's Fujitrail Hoodie, Green Gecko Heather, XX-Large	
B00NVQOBKK	ASICS Men's Fujitrail Hoodie, Green Gecko Heather, Large	
B00NVQOBKA	ASICS Men's Fujitrail Hoodie, Green Gecko Heather, Medium	
B00NVQO8SA	ASICS Men's Fujitrail Hoodie, Green Gecko Heather, Small	
B00NVQOBAU	ASICS Men's Fujitrail Hoodie, Green Gecko Heather, X-Large	
B00NVQOHNQ	ASICS Men's Fujitrail Packable Jacket, Heather Print, Large	
B00NVQOHL8	ASICS Men's Fujitrail Packable Jacket, Heather Print, Medium	
B00NVQOBK0	ASICS Men's Fujitrail Packable Jacket, Heather Print, Small	
B00NVQOI8K	ASICS Men's Fujitrail Packable Jacket, Heather Print, X-Large	
B00NVQOM4A	ASICS Men's Fujitrail Packable Jacket, Green Gecko Print, XX-Large	
B00NVQOM1I	ASICS Men's Fujitrail Packable Jacket, Green Gecko Print, Large	
B00NVQOM04	ASICS Men's Fujitrail Packable Jacket, Green Gecko Print, Medium	
B00NVQOHLI	ASICS Men's Fujitrail Packable Jacket, Green Gecko Print, Small	
B00NVQOM22	ASICS Men's Fujitrail Packable Jacket, Green Gecko Print, X-Large	
B00NVQOQBY	ASICS Men's Fujitrail Packable Jacket, Shocking Orange Print, Large	
B00NVQOQB4	ASICS Men's Fujitrail Packable Jacket, Shocking Orange Print, Medium	
B00NVQOM36	ASICS Men's Fujitrail Packable Jacket, Shocking Orange Print, Small	
B00NVQOQF0	ASICS Men's Fujitrail Packable Jacket, Shocking Orange Print, X-Large	
B00YPSGTDA	Mens ASICS Fujitrail Knee Tight, Balance Black, XXL	
B00YPSGKMU	Mens ASICS Fujitrail Knee Tight, Balance Black, L	
B00YPSGMPK	Mens ASICS Fujitrail Knee Tight, Balance Black, M	
B00YPSGOR6	Mens ASICS Fujitrail Knee Tight, Balance Black, S	
B00YPSGQZG	Mens ASICS Fujitrail Knee Tight, Balance Black, XL	
B00NVQOTFW	ASICS Men's Fujitrail Tights, Performance Black, XX-Large	
B00NVQOTQ6	ASICS Men's Fujitrail Tights, Performance Black, Large	
B00NVQOTMA	ASICS Men's Fujitrail Tights, Performance Black, Medium	
B00NVQOQD2	ASICS Men's Fujitrail Tights, Performance Black, Small	
B00NVQOTIO	ASICS Men's Fujitrail Tights, Performance Black, X-Large	
B00U2J99BK	ASICS Men's Fujitrail Tights, XX-Large, Balance Black	
B00U2J99EM	ASICS Men's Fujitrail Tights, Large, Balance Black	
B00U2J9B9U	ASICS Men's Fujitrail Tights, Medium, Balance Black	
B00U2J9BAO	ASICS Men's Fujitrail Tights, Small, Balance Black	
B00U2J9BGI	ASICS Men's Fujitrail Tights, X-Large, Balance Black	
B00NVQS2K0	ASICS Men's Fujitrail 2-N-1 Shorts, Performance Black, Large	
B00NVQOW36	ASICS Men's Fujitrail 2-N-1 Shorts, Performance Black, Medium	
B00NVQOTJS	ASICS Men's Fujitrail 2-N-1 Shorts, Performance Black, Small	
B00NVQS2TG	ASICS Men's Fujitrail 2-N-1 Shorts, Performance Black, X-Large	
B00NVQS73M	ASICS Men's Fujitrail 2-N-1 Shorts, Oak Green, XX-Large	
B00NVQS6S8	ASICS Men's Fujitrail 2-N-1 Shorts, Oak Green, Large	
B00NVQS6NS	ASICS Men's Fujitrail 2-N-1 Shorts, Oak Green, Medium	
B00NVQS2QY	ASICS Men's Fujitrail 2-N-1 Shorts, Oak Green, Small	
B00NVQS75U	ASICS Men's Fujitrail 2-N-1 Shorts, Oak Green, X-Large	
B00NVQSA2U	ASICS Women's Fujitrail Sleeveless Tank, Fizzy Peach Heather, Large	
B00NVQSBLA	ASICS Women's Fujitrail Sleeveless Tank, Fizzy Peach Heather, Medium	
B00NVQSA52	ASICS Women's Fujitrail Sleeveless Tank, Fizzy Peach Heather, Small	
B00NVQSA34	ASICS Women's Fujitrail Sleeveless Tank, Fizzy Peach Heather, X-Large	
B00NVQS6WY	ASICS Women's Fujitrail Sleeveless Tank, Fizzy Peach Heather, X-Small	
B00NVQSEEE	ASICS Women's Fujitrail Sleeveless Tank, Heather Grey, Large	
B00NVQSEYE	ASICS Women's Fujitrail Sleeveless Tank, Heather Grey, Medium	
B00NVQSEF8	ASICS Women's Fujitrail Sleeveless Tank, Heather Grey, Small	
B00NVQSE8K	ASICS Women's Fujitrail Sleeveless Tank, Heather Grey, X-Large	
B00NVQSA1G	ASICS Women's Fujitrail Sleeveless Tank, Heather Grey, X-Small	
B00NVQSHBY	ASICS Women's Fujitrail Sleeveless Tank, Performance Black, Large	
B00NVQSH8M	ASICS Women's Fujitrail Sleeveless Tank, Performance Black, Medium	
B00NVQSH50	ASICS Women's Fujitrail Sleeveless Tank, Performance Black, Small	
B00NVQSHCS	ASICS Women's Fujitrail Sleeveless Tank, Performance Black, X-Large	
B00NVQSEA8	ASICS Women's Fujitrail Sleeveless Tank, Performance Black, X-Small	
B00NVQSKJS	ASICS Women's Fujitrail Sleeveless Tank, Jeans Heather, Large	
B00NVQSKNE	ASICS Women's Fujitrail Sleeveless Tank, Jeans Heather, Medium	
B00NVQSKBQ	ASICS Women's Fujitrail Sleeveless Tank, Jeans Heather, Small	
B00NVQSKT8	ASICS Women's Fujitrail Sleeveless Tank, Jeans Heather, X-Large	
B00NVQSHE6	ASICS Women's Fujitrail Sleeveless Tank, Jeans Heather, X-Small	
B00NVQSN6S	ASICS Women's Fujitrail Hoodie, Purple Magic Heather, Large	
B00NVQSN1S	ASICS Women's Fujitrail Hoodie, Purple Magic Heather, Medium	
B00NVQSMZ0	ASICS Women's Fujitrail Hoodie, Purple Magic Heather, Small	
B00NVQSN72	ASICS Women's Fujitrail Hoodie, Purple Magic Heather, X-Large	
B00NVQSKU2	ASICS Women's Fujitrail Hoodie, Purple Magic Heather, X-Small	
B00NVQSRHS	ASICS Women's Fujitrail Hoodie, Heather Grey, Large	
B00NVQSRK0	ASICS Women's Fujitrail Hoodie, Heather Grey, Medium	
B00NVQSRMS	ASICS Women's Fujitrail Hoodie, Heather Grey, Small	
B00NVQSRHI	ASICS Women's Fujitrail Hoodie, Heather Grey, X-Large	
B00NVQSN4U	ASICS Women's Fujitrail Hoodie, Heather Grey, X-Small	
B00NVQSXHM	ASICS Women's Fujitrail Hoodie, Jeans Heather, Large	
B00NVQSXGS	ASICS Women's Fujitrail Hoodie, Jeans Heather, Medium	
B00NVQSXMM	ASICS Women's Fujitrail Hoodie, Jeans Heather, Small	
B00NVQSXJK	ASICS Women's Fujitrail Hoodie, Jeans Heather, X-Large	
B00NVQSUT8	ASICS Women's Fujitrail Hoodie, Jeans Heather, X-Small	
B00NVR3DPS	ASICS Women's Fujitrail Packable Jacket, Jeans Print, Large	
B00NVR3DKI	ASICS Women's Fujitrail Packable Jacket, Jeans Print, Medium	
B00NVR3DP8	ASICS Women's Fujitrail Packable Jacket, Jeans Print, Small	
B00NVR3DQC	ASICS Women's Fujitrail Packable Jacket, Jeans Print, X-Large	
B00NVQSXVS	ASICS Women's Fujitrail Packable Jacket, Jeans Print, X-Small	
B00NVR3GLY	ASICS Women's Fujitrail Packable Jacket, Purple Magic Print, Large	
B00NVR3GOG	ASICS Women's Fujitrail Packable Jacket, Purple Magic Print, Medium	
B00NVR3GM8	ASICS Women's Fujitrail Packable Jacket, Purple Magic Print, Small	
B00NVR3GW8	ASICS Women's Fujitrail Packable Jacket, Purple Magic Print, X-Large	
B00NVR3DPI	ASICS Women's Fujitrail Packable Jacket, Purple Magic Print, X-Small	
B00NVR3KVK	ASICS Women's Fujitrail Packable Jacket, Fizzy Peach Print, Large	
B00NVR3KW4	ASICS Women's Fujitrail Packable Jacket, Fizzy Peach Print, Medium	
B00NVR3KUG	ASICS Women's Fujitrail Packable Jacket, Fizzy Peach Print, Small	
B00NVR3L32	ASICS Women's Fujitrail Packable Jacket, Fizzy Peach Print, X-Large	
B00NVR3GKU	ASICS Women's Fujitrail Packable Jacket, Fizzy Peach Print, X-Small	
B00YPS347O	Women's ASICS FujiTrail Knee Tight, Dark Grey, L	
B00YPS36Y0	Women's ASICS FujiTrail Knee Tight, Dark Grey, M	
B00YPS39N8	Women's ASICS FujiTrail Knee Tight, Dark Grey, S	
B00YPS3E60	Women's ASICS FujiTrail Knee Tight, Dark Grey, XL	
B00YPS3GOA	Women's ASICS FujiTrail Knee Tight, Dark Grey, XS	
B00NVR3OMU	ASICS Women's Fujitrail Knee Tights, Performance Black, X-Large	
B00YPS2NXU	Women's ASICS FujiTrail Knee Tight, Balance Black, L	
B00YPS2R7W	Women's ASICS FujiTrail Knee Tight, Balance Black, M	
B00YPS2U5Q	Women's ASICS FujiTrail Knee Tight, Balance Black, S	
B00YPS2X4O	Women's ASICS FujiTrail Knee Tight, Balance Black, XL	
B00YPS31KO	Women's ASICS FujiTrail Knee Tight, Balance Black, XS	
B00U2J9BN6	ASICS Women's Fujitrail Tights, Large, Dark Grey	
B00U2J9BHM	ASICS Women's Fujitrail Tights, Medium, Dark Grey	
B00U2J9BFE	ASICS Women's Fujitrail Tights, Small, Dark Grey	
B00U2J9BEU	ASICS Women's Fujitrail Tights, X-Large, Dark Grey	
B00U2J9E2Y	ASICS Women's Fujitrail Tights, X-Small, Dark Grey	
B00NVR3O8Y	ASICS Women's Fujitrail Tights, Performance Black, X-Small	
B00U2J9E06	ASICS Women's Fujitrail Tights, Large, Balance Black	
B00U2J9DY8	ASICS Women's Fujitrail Tights, Medium, Balance Black	
B00U2J9E3S	ASICS Women's Fujitrail Tights, Small, Balance Black	
B00U2J9DXE	ASICS Women's Fujitrail Tights, X-Large, Balance Black	
B00U2J9E0G	ASICS Women's Fujitrail Tights, X-Small, Balance Black	
B00YPRNKV0	Womens ASICS Fujitrail 2-N-1 Short, Dark Grey, L	
B00YPRNPHO	Womens ASICS Fujitrail 2-N-1 Short, Dark Grey, S	
B00YPRNSB2	Womens ASICS Fujitrail 2-N-1 Short, Dark Grey, XL	
B00YPRNV0A	Womens ASICS Fujitrail 2-N-1 Short, Dark Grey, XS	
B00YPRN2F4	Womens ASICS Fujitrail 2-N-1 Short, Balance Black, L	
B00YPRN7MM	Womens ASICS Fujitrail 2-N-1 Short, Balance Black, M	
B00YPRNAEC	Womens ASICS Fujitrail 2-N-1 Short, Balance Black, S	
B00YPRNDRQ	Womens ASICS Fujitrail 2-N-1 Short, Balance Black, XL	
B00YPRNHV8	Womens ASICS Fujitrail 2-N-1 Short, Balance Black, XS	
B00NVR43LQ	ASICS Men's Athlete Sleeveless Top, Graphic Stripe Oak Green, XX-Large	
B00NVR43QG	ASICS Men's Athlete Sleeveless Top, Graphic Stripe Oak Green, Large	
B00NVR43HU	ASICS Men's Athlete Sleeveless Top, Graphic Stripe Oak Green, Medium	
B00NVR3YDY	ASICS Men's Athlete Sleeveless Top, Graphic Stripe Oak Green, Small	
B00NVR44CE	ASICS Men's Athlete Sleeveless Top, Graphic Stripe Oak Green, X-Large	
B00NVR46RW	ASICS Men's Athlete Sleeveless Top, Graphic Stripe Safety Yellow, XX-Large	
B00NVR46WC	ASICS Men's Athlete Sleeveless Top, Graphic Stripe Safety Yellow, Large	
B00NVR46SG	ASICS Men's Athlete Sleeveless Top, Graphic Stripe Safety Yellow, Medium	
B00NVR43W0	ASICS Men's Athlete Sleeveless Top, Graphic Stripe Safety Yellow, Small	
B00NVR46U4	ASICS Men's Athlete Sleeveless Top, Graphic Stripe Safety Yellow, X-Large	
B00NOL6NMG	ASICS Men's Athlete Sleeveless Top, XX-Large, Graphic Stripe Shocking Orange	
B00NOL6NF8	ASICS Men's Athlete Sleeveless Top, Large, Graphic Stripe Shocking Orange	
B00NOL6NHQ	ASICS Men's Athlete Sleeveless Top, Medium, Graphic Stripe Shocking Orange	
B00NOL6NEO	ASICS Men's Athlete Sleeveless Top, Small, Graphic Stripe Shocking Orange	
B00NOL6NNU	ASICS Men's Athlete Sleeveless Top, X-Large, Graphic Stripe Shocking Orange	
B00NVR4A8C	ASICS Men's Athlete Sleeveless Top, Air Force Blue, XX-Large	
B00NVR4A9G	ASICS Men's Athlete Sleeveless Top, Air Force Blue, Large	
B00NVR4A4Q	ASICS Men's Athlete Sleeveless Top, Air Force Blue, Medium	
B00NVR46Y0	ASICS Men's Athlete Sleeveless Top, Air Force Blue, Small	
B00NVR4AFA	ASICS Men's Athlete Sleeveless Top, Air Force Blue, X-Large	
B00NOL6R2M	ASICS Men's Athlete Short Sleeve Graphic Top, XX-Large, Real White	
B00NOL6R36	ASICS Men's Athlete Short Sleeve Graphic Top, Large, Real White	
B00NOL6QSM	ASICS Men's Athlete Short Sleeve Graphic Top, Medium, Real White	
B00NOL6QOG	ASICS Men's Athlete Short Sleeve Graphic Top, Small, Real White	
B00NOL6R0E	ASICS Men's Athlete Short Sleeve Graphic Top, X-Large, Real White	
B00NW2UV4I	ASICS Men's Athlete Short Sleeve Graphic Top, Safety Yellow, XX-Large	
B00NW2UU2Q	ASICS Men's Athlete Short Sleeve Graphic Top, Safety Yellow, Large	
B00NW2UTYA	ASICS Men's Athlete Short Sleeve Graphic Top, Safety Yellow, Medium	
B00NW2UU0S	ASICS Men's Athlete Short Sleeve Graphic Top, Safety Yellow, Small	
B00NW2UV6Q	ASICS Men's Athlete Short Sleeve Graphic Top, Safety Yellow, X-Large	
B00NW2UWXS	ASICS Men's Athlete Short Sleeve Graphic Top, Air Force Blue, XX-Large	
B00NW2UV34	ASICS Men's Athlete Short Sleeve Graphic Top, Air Force Blue, Large	
B00NW2UV3Y	ASICS Men's Athlete Short Sleeve Graphic Top, Air Force Blue, Medium	
B00NW2UV66	ASICS Men's Athlete Short Sleeve Graphic Top, Air Force Blue, Small	
B00NW2UWZ6	ASICS Men's Athlete Short Sleeve Graphic Top, Air Force Blue, X-Large	
B00NW2UYUO	ASICS Men's Athlete Lightweight Polo, Real White, XX-Large	
B00NW2UWWE	ASICS Men's Athlete Lightweight Polo, Real White, Large	
B00NW2UX2S	ASICS Men's Athlete Lightweight Polo, Real White, Medium	
B00NW2UX0A	ASICS Men's Athlete Lightweight Polo, Real White, Small	
B00NW2UYRW	ASICS Men's Athlete Lightweight Polo, Real White, X-Large	
B00NW2V048	ASICS Men's Athlete Lightweight Polo, Oak Green, XX-Large	
B00NW2UYV8	ASICS Men's Athlete Lightweight Polo, Oak Green, Large	
B00NW2UYSQ	ASICS Men's Athlete Lightweight Polo, Oak Green, Medium	
B00NW2UYSG	ASICS Men's Athlete Lightweight Polo, Oak Green, Small	
B00NW38RBG	ASICS Men's Athlete Lightweight Polo, Oak Green, X-Large	
B00NW2V070	ASICS Men's Athlete Lightweight Polo, Air Force Blue, Large	
B00NW2V020	ASICS Men's Athlete Lightweight Polo, Air Force Blue, Medium	
B00NW2V07A	ASICS Men's Athlete Lightweight Polo, Air Force Blue, Small	
B00NW2V782	ASICS Men's Athlete Lightweight Polo, Air Force Blue, X-Large	
B00NVR898O	ASICS Men's Tennis 9-Inch Knit Shorts, Graphic Stripe Oak Green, XX-Large	
B00NVR8A56	ASICS Men's Tennis 9-Inch Knit Shorts, Graphic Stripe Oak Green, Large	
B00NVR8934	ASICS Men's Tennis 9-Inch Knit Shorts, Graphic Stripe Oak Green, Medium	
B00NVR894S	ASICS Men's Tennis 9-Inch Knit Shorts, Graphic Stripe Oak Green, Small	
B00NVR895C	ASICS Men's Tennis 9-Inch Knit Shorts, Graphic Stripe Oak Green, X-Large	
B00NOL6VBY	ASICS Men's Knit Short 10-Inch, Large, Graphic Stripe Air Force Blue	
B00NOL6UQ0	ASICS Men's Knit Short 10-Inch, Medium, Graphic Stripe Air Force Blue	
B00NOL6V82	ASICS Men's Knit Short 10-Inch, X-Large, Graphic Stripe Air Force Blue	
B00NVR8E2A	ASICS Men's Tennis 9-Inch Knit Shorts, Graphic Stripe Performance Black, Medium	
B00NVR8DNK	ASICS Men's Tennis 9-Inch Knit Shorts, Graphic Stripe Performance Black, Small	
B00NVR8DOY	ASICS Men's Tennis 9-Inch Knit Shorts, Graphic Stripe Performance Black, X-Large	
B00NVR8IFI	ASICS Men's Athlete 2-N-1 9-Inch Shorts, Real White, XX-Large	
B00NVR8INK	ASICS Men's Athlete 2-N-1 9-Inch Shorts, Real White, Large	
B00NVR8IEE	ASICS Men's Athlete 2-N-1 9-Inch Shorts, Real White, Medium	
B00NVR8I9Y	ASICS Men's Athlete 2-N-1 9-Inch Shorts, Real White, Small	
B00NVR8IOY	ASICS Men's Athlete 2-N-1 9-Inch Shorts, Real White, X-Large	
B00NVRKZHW	ASICS Men's Athlete 2-N-1 9-Inch Shorts, Performance Black, XX-Large	
B00NVR8MEA	ASICS Men's Athlete 2-N-1 9-Inch Shorts, Performance Black, Large	
B00NVR8MG8	ASICS Men's Athlete 2-N-1 9-Inch Shorts, Performance Black, Medium	
B00NVR8M68	ASICS Men's Athlete 2-N-1 9-Inch Shorts, Performance Black, Small	
B00NVR8MFE	ASICS Men's Athlete 2-N-1 9-Inch Shorts, Performance Black, X-Large	
B00NVRL35U	ASICS Men's Athlete 2-N-1 9-Inch Shorts, Oak Green, XX-Large	
B00NVRKZB8	ASICS Men's Athlete 2-N-1 9-Inch Shorts, Oak Green, Large	
B00NVRKZ5O	ASICS Men's Athlete 2-N-1 9-Inch Shorts, Oak Green, Medium	
B00NVRKZLS	ASICS Men's Athlete 2-N-1 9-Inch Shorts, Oak Green, Small	
B00NVRL2YW	ASICS Men's Athlete 2-N-1 9-Inch Shorts, Oak Green, X-Large	
B00NOL70O6	ASICS Men's Athlete 2-in-1 Short 9-Inch, Large, Air Force Blue	
B00NOL70RI	ASICS Men's Athlete 2-in-1 Short 9-Inch, Medium, Air Force Blue	
B00NOL712M	ASICS Men's Athlete 2-in-1 Short 9-Inch, Small, Air Force Blue	
